//MAP CONVERTED BY dmm2tgm.py THIS HEADER COMMENT PREVENTS RECONVERSION, DO NOT REMOVE
"a" = (
/turf/open/space/basic,
/area/space)
"g" = (
/obj/structure/window/plasma/reinforced/fulltile,
/turf/open/floor/plating,
/area/space)
"m" = (
/obj/structure/catwalk/over/plated_catwalk/dark,
/turf/open/floor/plating,
/area/space)
"q" = (
/turf/open/floor/engine/hull/reinforced,
/area/space)
"s" = (
/obj/machinery/computer/turbine_computer{
	dir = 4
	},
/turf/open/floor/plasteel/patterned/brushed,
/area/space)
"E" = (
/turf/open/floor/plasteel/patterned/brushed,
/area/space)
"F" = (
/obj/machinery/power/compressor{
	dir = 4
	},
/turf/open/floor/engine/airless,
/area/space)
"G" = (
/turf/open/floor/plating,
/area/space)
"K" = (
/turf/closed/wall/mineral/titanium/nodiagonal,
/area/space)
"M" = (
/obj/effect/decal/cleanable/dirt,
/turf/open/floor/engine/hull/reinforced,
/area/space)
"S" = (
/turf/open/floor/engine/airless,
/area/space)
"T" = (
/obj/structure/catwalk/over/plated_catwalk/dark,
/obj/machinery/power/shuttle/engine/turbine{
	dir = 8
	},
/turf/open/floor/plating,
/area/space)

(1,1,1) = {"
a
a
a
a
a
a
a
a
a
a
a
a
a
a
a
a
a
a
a
a
a
a
a
a
a
a
a
a
a
a
a
a
a
a
a
a
a
a
a
a
"}
(2,1,1) = {"
a
a
a
a
a
a
a
a
a
a
a
a
a
a
a
a
a
a
a
a
a
a
a
a
a
a
a
a
a
a
a
a
a
a
a
a
a
a
a
a
"}
(3,1,1) = {"
a
a
a
a
a
a
a
a
a
a
a
a
a
a
a
a
a
a
a
a
a
a
a
a
a
a
a
a
a
a
a
a
a
a
a
a
a
a
a
a
"}
(4,1,1) = {"
a
a
a
a
a
a
a
a
a
a
a
a
a
a
a
a
a
a
a
a
a
a
a
a
a
a
a
a
a
a
a
a
a
a
a
a
a
a
a
a
"}
(5,1,1) = {"
a
a
a
a
a
q
q
q
q
a
a
a
a
a
a
a
a
a
a
a
a
a
a
a
a
a
a
a
a
a
q
q
q
q
a
a
a
a
a
a
"}
(6,1,1) = {"
a
a
a
a
m
m
m
T
K
q
a
a
a
a
a
a
a
a
a
a
a
a
a
a
a
a
a
a
a
q
K
T
m
m
m
a
a
a
a
a
"}
(7,1,1) = {"
a
a
a
K
m
K
K
F
K
K
a
a
a
a
a
a
a
a
a
a
a
a
a
a
a
a
a
a
a
K
K
F
K
K
m
K
a
a
a
a
"}
(8,1,1) = {"
a
a
a
K
m
K
S
S
S
K
a
a
a
a
a
a
a
a
a
a
a
a
a
a
a
a
a
a
a
K
S
S
S
K
m
K
a
a
a
a
"}
(9,1,1) = {"
a
a
K
K
m
K
g
g
g
K
a
a
a
a
a
a
a
a
a
a
a
a
a
a
a
a
a
a
a
K
g
g
g
K
m
K
K
a
a
a
"}
(10,1,1) = {"
a
a
K
s
m
E
E
E
E
K
a
a
a
a
a
a
a
a
a
a
a
a
a
a
a
a
a
a
a
K
E
E
E
E
m
s
K
a
a
a
"}
(11,1,1) = {"
a
a
K
E
E
E
E
E
E
K
a
a
a
a
a
a
K
K
K
K
K
K
K
a
a
a
a
a
a
K
E
E
E
E
E
E
K
a
a
a
"}
(12,1,1) = {"
a
a
K
E
E
E
E
E
K
K
a
a
a
a
K
K
K
E
E
E
E
E
K
K
K
a
a
a
a
K
K
E
E
E
E
E
K
a
a
a
"}
(13,1,1) = {"
a
a
K
E
E
E
E
E
K
a
a
a
a
K
K
E
E
E
E
E
E
E
E
E
K
K
a
a
a
a
K
E
E
E
E
E
K
a
a
a
"}
(14,1,1) = {"
a
a
K
E
E
E
E
E
K
a
a
a
a
K
E
E
E
E
E
E
E
E
E
E
E
K
a
a
a
a
K
E
E
E
E
E
K
a
a
a
"}
(15,1,1) = {"
a
a
K
E
E
E
E
E
K
a
a
a
a
K
E
E
E
E
E
E
E
E
E
E
E
K
a
a
a
a
K
E
E
E
E
E
K
a
a
a
"}
(16,1,1) = {"
a
a
K
E
E
E
E
E
K
a
a
a
a
K
E
E
E
E
E
E
E
E
E
E
E
K
a
a
a
a
K
E
E
E
E
E
K
a
a
a
"}
(17,1,1) = {"
a
a
K
E
E
E
E
E
K
a
a
a
a
K
K
K
K
E
E
E
E
E
K
K
K
K
a
a
a
a
K
E
E
E
E
E
K
a
a
a
"}
(18,1,1) = {"
a
K
K
g
K
K
E
K
K
q
a
a
a
K
E
E
E
E
E
E
E
E
E
E
E
K
a
a
a
q
K
K
E
E
K
g
K
K
a
a
"}
(19,1,1) = {"
a
K
S
S
g
E
E
E
K
M
q
a
a
K
E
E
E
E
E
E
E
E
E
E
E
K
a
a
q
q
K
E
E
E
G
S
S
K
a
a
"}
(20,1,1) = {"
a
K
S
S
g
E
E
E
K
K
K
K
K
K
E
E
E
E
E
E
E
E
E
E
E
K
K
K
K
K
K
E
E
E
g
S
S
K
a
a
"}
(21,1,1) = {"
a
K
g
g
K
E
E
E
K
E
E
E
E
K
E
E
E
E
E
E
E
E
E
E
E
K
E
E
E
E
K
E
E
E
K
g
g
K
a
a
"}
(22,1,1) = {"
a
K
E
E
E
E
E
E
E
E
E
E
E
E
E
E
E
E
E
E
E
E
E
E
E
E
E
E
E
E
E
E
E
E
E
E
E
K
a
a
"}
(23,1,1) = {"
a
K
E
E
E
E
E
E
E
E
E
E
E
E
E
E
E
E
E
E
E
E
E
E
E
E
E
E
E
E
E
E
E
E
E
E
E
K
a
a
"}
(24,1,1) = {"
a
K
E
E
E
E
E
E
K
E
E
E
E
K
E
E
E
E
E
E
E
E
E
E
E
K
E
E
E
E
K
E
E
E
E
E
E
K
a
a
"}
(25,1,1) = {"
a
K
K
K
K
K
E
K
K
K
K
K
K
K
E
E
E
E
E
E
E
E
E
E
E
K
K
E
K
K
K
K
K
E
K
K
K
K
a
a
"}
(26,1,1) = {"
a
K
E
E
E
E
E
E
E
E
E
E
E
K
E
E
E
E
E
E
E
E
E
E
E
K
E
E
E
E
E
E
K
E
E
E
E
K
a
a
"}
(27,1,1) = {"
a
K
E
E
E
E
E
E
E
E
E
E
E
K
K
E
E
E
E
E
E
E
E
E
K
K
E
E
E
E
E
E
E
E
E
E
E
K
a
a
"}
(28,1,1) = {"
a
K
E
E
E
E
E
E
E
E
E
E
E
E
K
K
K
K
E
K
E
K
K
K
K
E
E
E
E
E
E
E
K
E
E
E
E
K
a
a
"}
(29,1,1) = {"
a
K
E
E
E
E
E
E
E
E
E
E
E
E
E
K
E
E
E
E
E
E
E
K
E
E
E
E
E
E
E
E
K
E
E
E
E
K
a
a
"}
(30,1,1) = {"
a
K
K
E
E
E
E
E
E
E
E
E
E
E
E
K
E
E
E
E
E
E
E
K
E
E
E
E
E
E
E
E
K
E
E
E
K
K
a
a
"}
(31,1,1) = {"
a
a
K
E
E
E
E
E
E
E
E
E
E
E
E
K
E
E
E
E
E
E
E
K
E
E
E
E
E
E
E
E
K
E
E
E
K
a
a
a
"}
(32,1,1) = {"
a
a
K
K
E
E
E
E
E
E
E
E
E
E
E
K
E
E
E
E
E
E
E
K
E
E
E
E
E
E
E
E
K
E
E
K
K
a
a
a
"}
(33,1,1) = {"
a
a
a
K
E
E
E
E
E
K
K
K
K
K
K
K
E
E
E
E
E
E
E
K
E
E
E
E
E
E
E
E
K
E
E
K
a
a
a
a
"}
(34,1,1) = {"
a
a
a
K
K
E
E
E
E
K
E
E
E
E
E
K
E
E
E
E
E
E
E
K
E
E
E
E
E
E
E
E
K
E
K
K
a
a
a
a
"}
(35,1,1) = {"
a
a
a
a
K
K
E
E
E
K
E
E
E
E
E
K
E
E
E
E
E
E
E
K
E
E
E
E
E
E
E
E
K
K
K
a
a
a
a
a
"}
(36,1,1) = {"
a
a
a
a
a
K
K
K
K
K
E
E
E
E
E
K
E
E
E
E
E
E
E
K
E
E
E
E
E
E
E
E
K
K
a
a
a
a
a
a
"}
(37,1,1) = {"
a
a
a
a
a
a
K
E
E
E
E
E
E
E
E
K
K
q
q
q
q
q
K
K
E
E
E
E
E
E
E
E
K
a
a
a
a
a
a
a
"}
(38,1,1) = {"
a
a
a
a
a
a
K
E
E
E
E
E
E
E
K
K
q
q
q
q
q
q
q
K
K
E
E
E
E
E
E
E
K
a
a
a
a
a
a
a
"}
(39,1,1) = {"
a
a
a
a
a
a
K
E
E
E
E
E
E
E
K
q
q
q
q
q
q
q
q
q
K
E
E
E
E
E
E
E
K
a
a
a
a
a
a
a
"}
(40,1,1) = {"
a
a
a
a
a
a
K
E
E
E
E
E
E
E
K
q
q
q
q
q
q
q
q
q
K
E
E
E
E
E
E
E
K
a
a
a
a
a
a
a
"}
(41,1,1) = {"
a
a
a
a
a
a
K
E
E
E
E
E
E
E
K
a
q
q
q
q
q
q
q
a
K
E
E
E
E
E
E
E
K
a
a
a
a
a
a
a
"}
(42,1,1) = {"
a
a
a
a
a
a
K
K
E
E
E
E
K
K
K
a
a
a
a
a
a
a
a
a
K
K
K
K
E
E
K
K
K
a
a
a
a
a
a
a
"}
(43,1,1) = {"
a
a
a
a
a
a
a
K
E
E
E
E
K
a
a
a
a
a
a
a
a
a
a
a
a
a
K
E
E
E
E
K
a
a
a
a
a
a
a
a
"}
(44,1,1) = {"
a
a
a
a
a
a
a
K
E
E
E
E
K
a
a
a
a
a
a
a
a
a
a
a
a
a
K
E
E
E
E
K
a
a
a
a
a
a
a
a
"}
(45,1,1) = {"
a
a
a
a
a
a
a
K
E
E
E
E
K
a
a
a
a
a
a
a
a
a
a
a
a
a
K
E
E
E
E
K
a
a
a
a
a
a
a
a
"}
(46,1,1) = {"
a
a
a
a
a
a
a
K
K
E
E
E
K
a
a
a
a
a
a
a
a
a
a
a
a
a
K
E
E
E
K
K
a
a
a
a
a
a
a
a
"}
(47,1,1) = {"
a
a
a
a
a
a
a
a
K
K
K
K
K
a
a
a
a
a
a
a
a
a
a
a
a
a
K
K
K
K
K
a
a
a
a
a
a
a
a
a
"}
(48,1,1) = {"
a
a
a
a
a
a
a
a
a
a
a
a
a
a
a
a
a
a
a
a
a
a
a
a
a
a
a
a
a
a
a
a
a
a
a
a
a
a
a
a
"}
(49,1,1) = {"
a
a
a
a
a
a
a
a
a
a
a
a
a
a
a
a
a
a
a
a
a
a
a
a
a
a
a
a
a
a
a
a
a
a
a
a
a
a
a
a
"}
(50,1,1) = {"
a
a
a
a
a
a
a
a
a
a
a
a
a
a
a
a
a
a
a
a
a
a
a
a
a
a
a
a
a
a
a
a
a
a
a
a
a
a
a
a
"}
(51,1,1) = {"
a
a
a
a
a
a
a
a
a
a
a
a
a
a
a
a
a
a
a
a
a
a
a
a
a
a
a
a
a
a
a
a
a
a
a
a
a
a
a
a
"}
(52,1,1) = {"
a
a
a
a
a
a
a
a
a
a
a
a
a
a
a
a
a
a
a
a
a
a
a
a
a
a
a
a
a
a
a
a
a
a
a
a
a
a
a
a
"}
(53,1,1) = {"
a
a
a
a
a
a
a
a
a
a
a
a
a
a
a
a
a
a
a
a
a
a
a
a
a
a
a
a
a
a
a
a
a
a
a
a
a
a
a
a
"}
(54,1,1) = {"
a
a
a
a
a
a
a
a
a
a
a
a
a
a
a
a
a
a
a
a
a
a
a
a
a
a
a
a
a
a
a
a
a
a
a
a
a
a
a
a
"}
(55,1,1) = {"
a
a
a
a
a
a
a
a
a
a
a
a
a
a
a
a
a
a
a
a
a
a
a
a
a
a
a
a
a
a
a
a
a
a
a
a
a
a
a
a
"}
(56,1,1) = {"
a
a
a
a
a
a
a
a
a
a
a
a
a
a
a
a
a
a
a
a
a
a
a
a
a
a
a
a
a
a
a
a
a
a
a
a
a
a
a
a
"}
