//MAP CONVERTED BY dmm2tgm.py THIS HEADER COMMENT PREVENTS RECONVERSION, DO NOT REMOVE
"bL" = (
/turf/open/floor/plating/asteroid/iceberg,
/area/space)
"cj" = (
/obj/effect/turf_decal/number/left_zero,
/turf/open/floor/plating/asteroid/icerock,
/area/space)
"cw" = (
/obj/effect/turf_decal/number/right_four,
/turf/open/floor/plating,
/area/space)
"dq" = (
/obj/item/trash/can/food/beans,
/turf/open/floor/plating/asteroid/icerock,
/area/space)
"eG" = (
/obj/item/keycard/entry,
/turf/open/floor/plating,
/area/space)
"eI" = (
/obj/machinery/door/keycard,
/obj/item/keycard,
/turf/open/floor/plating,
/area/space)
"eZ" = (
/obj/structure/chair/plastic{
	dir = 4
	},
/turf/open/floor/plating/asteroid/icerock,
/area/space)
"gi" = (
/obj/item/gun/ballistic/shotgun/doublebarrel/brazil{
	pixel_x = 8
	},
/turf/open/floor/plating,
/area/space)
"gq" = (
/obj/machinery/power/apc/auto_name/directional/north,
/obj/structure/sign/number/six,
/turf/open/floor/plating,
/area/space)
"kf" = (
/obj/structure/cable/blue{
	icon_state = "1-2"
	},
/turf/open/floor/plating/icemoon,
/area/space)
"km" = (
/obj/structure/sign/number/four,
/turf/open/floor/plating,
/area/space)
"ly" = (
/turf/open/floor/plating,
/area/space)
"ns" = (
/obj/structure/sign/number/five,
/turf/open/floor/plating,
/area/space)
"nR" = (
/turf/closed/mineral/ice,
/area/space)
"nS" = (
/obj/structure/window/plasma/reinforced/plastitanium,
/turf/open/floor/plating,
/area/space)
"od" = (
/obj/effect/turf_decal/number/right_six,
/turf/open/floor/plating,
/area/space)
"pj" = (
/obj/structure/sign/number/one,
/turf/open/floor/plating,
/area/space)
"pE" = (
/obj/machinery/door/keycard,
/obj/item/keycard/entry,
/turf/open/floor/plating,
/area/space)
"pF" = (
/obj/machinery/button,
/obj/effect/turf_decal/number/right_zero,
/turf/open/floor/plating/icemoon,
/area/space)
"sf" = (
/obj/structure/chair/plastic{
	dir = 8
	},
/turf/open/floor/plating/icemoon,
/area/space)
"sC" = (
/turf/closed/wall,
/area/space)
"sQ" = (
/obj/machinery/power/port_gen/pacman,
/obj/structure/cable/blue,
/turf/open/floor/plating/icemoon,
/area/space)
"tz" = (
/obj/effect/turf_decal/number/right_seven,
/turf/open/floor/plating,
/area/space)
"tM" = (
/obj/machinery/power/apc/auto_name/directional/west,
/obj/structure/sign/number/four,
/turf/open/floor/plating,
/area/space)
"vh" = (
/obj/machinery/door/poddoor/shutters{
	dir = 4
	},
/turf/open/floor/plating/icemoon,
/area/space)
"wa" = (
/obj/machinery/power/apc/auto_name/directional/west,
/obj/structure/sign/number,
/turf/open/floor/plating/icemoon,
/area/space)
"wS" = (
/obj/item/stack/sheet/mineral/plasma/five,
/obj/item/wrench,
/turf/open/floor/plating/icemoon,
/area/space)
"wT" = (
/obj/machinery/power/port_gen/pacman,
/turf/open/floor/plating,
/area/space)
"xb" = (
/obj/machinery/power/apc/auto_name/directional/north,
/obj/structure/sign/number/two,
/turf/open/floor/plating/icemoon,
/area/space)
"yN" = (
/obj/structure/bonfire,
/obj/item/reagent_containers/food/snacks/canned/beans,
/turf/open/floor/plating/asteroid/icerock,
/area/space)
"yT" = (
/obj/effect/turf_decal/number/right_four,
/obj/machinery/button,
/turf/open/floor/plating,
/area/space)
"AG" = (
/obj/machinery/power/apc/auto_name/directional/north,
/obj/structure/sign/number/one,
/turf/open/floor/plating/icemoon,
/area/space)
"AT" = (
/obj/effect/turf_decal/number/right_zero,
/turf/open/floor/plating/icemoon,
/area/space)
"AX" = (
/obj/structure/closet/crate,
/obj/item/reagent_containers/food/snacks/sausage,
/obj/item/reagent_containers/food/snacks/canned/beans,
/turf/open/floor/plating/asteroid/icerock,
/area/space)
"Ba" = (
/obj/effect/turf_decal/number/left_zero,
/turf/open/floor/plating/icemoon,
/area/space)
"BT" = (
/obj/machinery/button,
/obj/effect/turf_decal/number/right_seven,
/turf/open/floor/plating,
/area/space)
"Cc" = (
/obj/structure/chair/plastic{
	dir = 8
	},
/turf/open/floor/plating/asteroid/icerock,
/area/space)
"Cu" = (
/obj/item/keycard,
/obj/structure/table,
/turf/open/floor/plating/asteroid/icerock,
/area/space)
"CY" = (
/obj/machinery/door/keycard,
/obj/item/keycard/stockroom,
/turf/open/floor/plating,
/area/space)
"Dt" = (
/obj/item/paper,
/obj/structure/table,
/turf/open/floor/plating/asteroid/icerock,
/area/space)
"Dv" = (
/obj/effect/turf_decal/number/right_zero,
/turf/open/floor/plating,
/area/space)
"EM" = (
/obj/machinery/button,
/obj/effect/turf_decal/number/right_three,
/turf/open/floor/plating,
/area/space)
"Fa" = (
/obj/effect/turf_decal/number/right_two,
/turf/open/floor/plating,
/area/space)
"Fh" = (
/obj/effect/turf_decal/number/right_three,
/turf/open/floor/plating/icemoon,
/area/space)
"Gk" = (
/obj/effect/turf_decal/number/left_one,
/turf/open/floor/plating/icemoon,
/area/space)
"GD" = (
/obj/structure/sign/number/six,
/turf/open/floor/plating,
/area/space)
"HZ" = (
/obj/effect/turf_decal/number/right_five,
/turf/open/floor/plating,
/area/space)
"Ie" = (
/obj/structure/sign/number/three,
/turf/open/floor/plating,
/area/space)
"Ij" = (
/obj/structure/table,
/obj/item/reagent_containers/food/drinks/waterbottle,
/turf/open/floor/plating/asteroid/icerock,
/area/space)
"IJ" = (
/obj/machinery/button,
/obj/effect/turf_decal/number/right_six,
/turf/open/floor/plating,
/area/space)
"Jb" = (
/obj/structure/table,
/turf/open/floor/plating/icemoon,
/area/space)
"Jj" = (
/obj/machinery/door/poddoor/shutters/indestructible{
	dir = 4
	},
/turf/open/floor/plating,
/area/space)
"Kc" = (
/obj/effect/turf_decal/number/right_two,
/turf/open/floor/plating/icemoon,
/area/space)
"Kz" = (
/obj/machinery/door/poddoor/shutters/indestructible,
/turf/open/floor/plating,
/area/space)
"Mf" = (
/obj/machinery/power/apc/auto_name/directional/north,
/obj/structure/sign/number/five,
/turf/open/floor/plating,
/area/space)
"Nw" = (
/obj/structure/chair/plastic{
	dir = 4
	},
/turf/open/floor/plating/icemoon,
/area/space)
"Qq" = (
/turf/closed/mineral/random/snow,
/area/space)
"Qs" = (
/obj/machinery/power/floodlight,
/obj/structure/cable/blue{
	icon_state = "0-2"
	},
/turf/open/floor/plating/icemoon,
/area/space)
"QJ" = (
/obj/effect/turf_decal/number/right_five,
/turf/open/floor/plating/icemoon,
/area/space)
"QU" = (
/turf/open/space/basic,
/area/space)
"QV" = (
/turf/open/floor/plating/icemoon,
/area/space)
"Rq" = (
/obj/structure/barricade/sandbags,
/turf/open/floor/plating/icemoon,
/area/space)
"Si" = (
/obj/machinery/button,
/turf/open/floor/plating,
/area/space)
"TM" = (
/obj/structure/chair/plastic,
/turf/open/floor/plating/asteroid/icerock,
/area/space)
"UY" = (
/obj/machinery/door/poddoor/shutters,
/turf/open/floor/plating,
/area/space)
"Vm" = (
/obj/machinery/power/apc/auto_name/directional/north,
/obj/structure/sign/number/three,
/turf/open/floor/plating,
/area/space)
"Vq" = (
/obj/structure/safe,
/obj/item/keycard,
/turf/open/floor/plating/icemoon,
/area/space)
"VH" = (
/obj/machinery/door/keycard,
/turf/open/floor/plating/icemoon,
/area/space)
"VT" = (
/obj/item/keycard/stockroom,
/turf/open/floor/plating,
/area/space)
"WB" = (
/obj/effect/turf_decal/number/left_one,
/turf/open/floor/plating/asteroid/icerock,
/area/space)
"Xe" = (
/obj/machinery/door/keycard,
/turf/open/floor/plating,
/area/space)
"YK" = (
/obj/structure/sign/number/two,
/turf/open/floor/plating,
/area/space)
"Zb" = (
/obj/machinery/power/port_gen/pacman,
/turf/open/floor/plating/icemoon,
/area/space)
"Zv" = (
/turf/open/floor/plating/asteroid/icerock,
/area/space)
"Zx" = (
/obj/structure/sign/number,
/turf/open/floor/plating/icemoon,
/area/space)

(1,1,1) = {"
QU
QU
QU
QU
QU
QU
QU
QU
QU
QU
QU
QU
QU
QU
QU
QU
QU
QU
QU
QU
QU
QU
QU
QU
QU
QU
QU
QU
QU
QU
QU
QU
QU
QU
QU
QU
QU
QU
QU
QU
QU
QU
QU
QU
QU
QU
QU
QU
QU
QU
QU
QU
QU
QU
QU
QU
QU
QU
QU
QU
QU
QU
QU
QU
"}
(2,1,1) = {"
QU
QU
QU
QU
QU
QU
QU
QU
QU
QU
QU
QU
QU
QU
QU
QU
QU
QU
QU
QU
Zv
nR
nR
nR
nR
nR
nR
Zv
nR
QU
QU
QU
QU
QU
QU
QU
QU
QU
QU
QU
QU
QU
QU
QU
QU
QU
QU
QU
QU
QU
QU
QU
QU
QU
QU
QU
QU
QU
QU
QU
QU
QU
QU
QU
"}
(3,1,1) = {"
QU
QU
QU
QU
QU
QU
QU
QU
QU
QU
QU
QU
QU
QU
QU
QU
QU
QU
nR
nR
nR
nR
nR
nR
nR
nR
nR
nR
Zv
nR
nR
nR
nR
nR
nR
nR
nR
QU
QU
QU
QU
QU
QU
QU
QU
QU
QU
QU
QU
QU
QU
QU
QU
QU
QU
QU
QU
QU
QU
QU
QU
QU
QU
QU
"}
(4,1,1) = {"
QU
QU
QU
QU
QU
QU
QU
QU
QU
QU
QU
QU
QU
QU
QU
nR
nR
nR
nR
nR
Zv
nR
Zv
nR
nR
nR
nR
nR
Zv
nR
Zv
nR
nR
nR
nR
nR
nR
nR
nR
QU
QU
QU
QU
QU
QU
QU
QU
QU
QU
QU
QU
QU
QU
QU
QU
QU
QU
QU
QU
QU
QU
QU
QU
QU
"}
(5,1,1) = {"
QU
QU
QU
QU
QU
QU
QU
QU
QU
QU
QU
QU
QU
QU
nR
nR
nR
nR
nR
nR
Zv
nR
nR
nR
nR
nR
nR
nR
nR
nR
Zv
Zv
nR
nR
nR
nR
nR
nR
nR
nR
QU
QU
QU
QU
QU
QU
QU
QU
QU
QU
QU
QU
QU
QU
QU
QU
QU
QU
QU
QU
QU
QU
QU
QU
"}
(6,1,1) = {"
QU
QU
QU
QU
QU
QU
QU
QU
QU
QU
QU
QU
QU
nR
nR
nR
nR
nR
nR
bL
nR
nR
nR
nR
nR
nR
nR
nR
nR
nR
nR
nR
Zv
Zv
nR
nR
bL
nR
nR
nR
nR
QU
QU
QU
QU
QU
QU
QU
QU
QU
QU
QU
QU
QU
QU
QU
QU
QU
QU
QU
QU
QU
QU
QU
"}
(7,1,1) = {"
QU
QU
QU
QU
QU
QU
QU
QU
QU
QU
QU
QU
QU
nR
nR
nR
nR
bL
bL
nR
nR
nR
nR
nR
nR
nR
nR
nR
nR
nR
nR
nR
nR
nR
nR
nR
nR
nR
nR
nR
nR
nR
nR
nR
QU
QU
QU
QU
QU
QU
QU
QU
QU
QU
QU
QU
QU
QU
QU
QU
QU
QU
QU
QU
"}
(8,1,1) = {"
QU
QU
QU
QU
QU
QU
QU
QU
QU
QU
QU
QU
nR
nR
nR
nR
nR
nR
bL
nR
nR
nR
nR
nR
nR
nR
nR
nR
nR
nR
nR
Zv
nR
nR
nR
nR
nR
nR
nR
nR
nR
nR
nR
nR
nR
nR
QU
QU
QU
QU
QU
QU
QU
QU
QU
QU
QU
QU
QU
QU
QU
QU
QU
QU
"}
(9,1,1) = {"
QU
QU
QU
QU
QU
QU
QU
QU
QU
QU
QU
QU
QU
nR
nR
nR
nR
nR
nR
nR
nR
nR
nR
Zv
nR
nR
nR
nR
nR
nR
nR
Zv
nR
nR
Zv
bL
nR
nR
nR
bL
nR
nR
nR
nR
nR
nR
nR
nR
QU
QU
QU
QU
QU
QU
QU
QU
QU
QU
QU
QU
QU
QU
QU
QU
"}
(10,1,1) = {"
QU
QU
QU
QU
QU
QU
QU
QU
QU
QU
QU
QU
QU
nR
nR
nR
Zv
nR
nR
Zv
Zv
nR
nR
nR
nR
nR
nR
nR
Qq
bL
nR
nR
nR
nR
nR
nR
nR
nR
nR
nR
nR
nR
nR
nR
nR
nR
nR
nR
nR
QU
QU
QU
QU
QU
QU
QU
QU
QU
QU
QU
QU
QU
QU
QU
"}
(11,1,1) = {"
QU
QU
QU
QU
QU
QU
QU
QU
QU
QU
QU
nR
QU
nR
nR
nR
nR
Zv
nR
nR
nR
nR
nR
nR
bL
nR
nR
nR
nR
nR
nR
nR
nR
nR
Zv
Zv
nR
nR
nR
nR
bL
nR
nR
nR
nR
nR
nR
nR
nR
QU
QU
QU
QU
QU
QU
QU
QU
QU
QU
QU
QU
QU
QU
QU
"}
(12,1,1) = {"
QU
QU
QU
QU
QU
QU
QU
QU
QU
QU
QU
nR
nR
nR
nR
nR
nR
nR
nR
nR
bL
nR
nR
nR
bL
nR
nR
nR
nR
nR
nR
nR
nR
nR
Zv
nR
nR
nR
nR
Zv
Zv
nR
nR
nR
nR
nR
nR
nR
nR
nR
QU
QU
QU
QU
QU
QU
QU
QU
QU
QU
QU
QU
QU
QU
"}
(13,1,1) = {"
QU
QU
QU
QU
QU
QU
QU
QU
QU
QU
QU
nR
nR
bL
nR
nR
nR
nR
nR
nR
nR
Zv
nR
nR
nR
nR
nR
bL
nR
nR
nR
bL
nR
nR
bL
Zv
nR
nR
nR
bL
nR
nR
nR
nR
nR
nR
nR
nR
nR
nR
nR
QU
QU
QU
QU
QU
QU
QU
QU
QU
QU
QU
QU
QU
"}
(14,1,1) = {"
QU
QU
QU
QU
QU
QU
QU
QU
QU
QU
nR
nR
nR
nR
nR
nR
nR
bL
Qq
bL
nR
bL
Zv
nR
nR
bL
nR
nR
Zv
nR
nR
bL
nR
nR
nR
nR
nR
nR
Zv
nR
nR
nR
nR
nR
nR
nR
nR
nR
nR
nR
nR
QU
QU
QU
QU
QU
QU
QU
QU
QU
QU
QU
QU
QU
"}
(15,1,1) = {"
QU
QU
QU
QU
QU
QU
QU
QU
QU
QU
nR
nR
nR
bL
nR
bL
nR
Zv
nR
nR
Zv
nR
nR
nR
nR
nR
Zv
nR
Zv
Zv
nR
nR
nR
nR
nR
nR
bL
nR
nR
Zv
nR
nR
nR
nR
nR
nR
nR
nR
nR
nR
nR
QU
QU
QU
QU
QU
QU
QU
QU
QU
QU
QU
QU
QU
"}
(16,1,1) = {"
QU
QU
QU
QU
QU
QU
QU
QU
QU
QU
nR
nR
nR
nR
nR
nR
Zv
Zv
bL
nR
nR
nR
nR
nR
nR
nR
nR
nR
nR
nR
nR
nR
Zv
nR
nR
nR
nR
Zv
nR
nR
nR
nR
nR
nR
Zv
nR
nR
nR
nR
nR
nR
QU
QU
QU
QU
QU
QU
QU
QU
QU
QU
QU
QU
QU
"}
(17,1,1) = {"
QU
QU
QU
QU
QU
QU
QU
QU
QU
nR
nR
nR
nR
nR
nR
nR
Qq
nR
nR
nR
nR
nR
nR
nR
nR
nR
nR
nR
nR
nR
nR
Qq
nR
nR
nR
Qq
nR
bL
nR
nR
nR
nR
nR
nR
nR
nR
nR
nR
nR
nR
nR
QU
QU
QU
QU
QU
QU
QU
QU
QU
QU
QU
QU
QU
"}
(18,1,1) = {"
QU
QU
QU
QU
QU
QU
QU
QU
QU
nR
nR
nR
nR
nR
nR
nR
nR
Zv
nR
nR
nR
nR
nR
nR
Zv
nR
bL
bL
nR
bL
nR
nR
nR
bL
Zv
bL
nR
nR
bL
nR
bL
nR
nR
nR
nR
Zv
nR
nR
nR
nR
nR
nR
QU
QU
QU
QU
QU
QU
QU
QU
QU
QU
QU
QU
"}
(19,1,1) = {"
QU
QU
QU
QU
QU
QU
QU
QU
nR
nR
nR
nR
bL
nR
nR
nR
bL
nR
nR
nR
nR
nR
bL
Zv
Zv
Zv
bL
bL
bL
bL
Zv
bL
bL
nR
nR
nR
nR
nR
nR
Zv
nR
nR
nR
nR
nR
nR
nR
nR
nR
nR
nR
nR
QU
QU
QU
QU
QU
QU
QU
QU
QU
QU
QU
QU
"}
(20,1,1) = {"
QU
QU
QU
QU
QU
QU
QU
QU
nR
nR
nR
nR
nR
nR
nR
bL
nR
nR
bL
nR
nR
nR
bL
Zv
Zv
bL
Zv
Zv
bL
bL
bL
bL
bL
bL
Zv
nR
nR
Zv
nR
nR
bL
nR
nR
nR
nR
nR
nR
nR
nR
nR
nR
nR
nR
QU
QU
QU
QU
QU
QU
QU
QU
QU
QU
QU
"}
(21,1,1) = {"
QU
QU
QU
QU
QU
QU
QU
nR
nR
nR
nR
nR
nR
Zv
bL
Zv
nR
Zv
nR
nR
nR
bL
bL
bL
bL
bL
Zv
bL
bL
Zv
bL
bL
Zv
Zv
Zv
Zv
nR
nR
bL
Zv
nR
Qq
nR
nR
nR
Zv
nR
nR
nR
nR
nR
nR
nR
QU
QU
QU
QU
QU
QU
QU
QU
QU
QU
QU
"}
(22,1,1) = {"
QU
QU
QU
QU
QU
QU
nR
nR
nR
nR
nR
nR
nR
nR
Zv
nR
nR
nR
nR
Zv
bL
bL
bL
bL
Zv
Zv
Zv
bL
Zv
Zv
bL
bL
bL
bL
Zv
Zv
Zv
nR
Zv
Zv
nR
nR
nR
nR
nR
nR
nR
nR
nR
nR
nR
nR
nR
QU
QU
QU
QU
QU
QU
QU
QU
QU
QU
QU
"}
(23,1,1) = {"
QU
QU
QU
QU
QU
QU
nR
nR
nR
nR
nR
nR
nR
nR
Zv
nR
nR
nR
nR
Zv
bL
bL
Zv
bL
bL
bL
Zv
bL
bL
Zv
Zv
bL
bL
Zv
Zv
bL
Zv
nR
nR
nR
nR
nR
nR
nR
nR
nR
nR
nR
nR
nR
nR
nR
nR
nR
QU
QU
QU
QU
QU
QU
QU
QU
QU
QU
"}
(24,1,1) = {"
QU
QU
QU
QU
QU
QU
nR
nR
nR
nR
nR
nR
nR
Zv
Zv
nR
nR
nR
bL
bL
bL
Zv
bL
bL
sC
sC
sC
sC
sC
Zv
Zv
bL
Zv
bL
bL
bL
bL
nR
Zv
nR
nR
nR
nR
nR
nR
nR
nR
Zv
nR
nR
nR
nR
nR
nR
QU
QU
QU
QU
QU
QU
QU
QU
QU
QU
"}
(25,1,1) = {"
QU
QU
QU
QU
QU
QU
nR
nR
nR
nR
nR
nR
nR
nR
nR
Zv
nR
nR
Zv
bL
bL
bL
bL
sC
sC
ly
ly
ly
sC
sC
bL
Zv
QV
sC
sC
sC
Zv
bL
nR
nR
nR
nR
nR
nR
nR
nR
nR
nR
Zv
nR
nR
nR
nR
nR
nR
QU
QU
QU
QU
QU
QU
QU
QU
QU
"}
(26,1,1) = {"
QU
QU
QU
QU
QU
nR
nR
nR
nR
nR
nR
nR
nR
nR
Zv
nR
nR
bL
Zv
Zv
Zv
bL
bL
sC
HZ
ly
sC
ly
EM
sC
bL
Zv
QV
QV
QV
sC
sC
QV
nR
nR
nR
Qq
nR
nR
nR
nR
nR
nR
nR
nR
nR
nR
nR
nR
nR
QU
QU
QU
QU
QU
QU
QU
QU
QU
"}
(27,1,1) = {"
QU
QU
QU
QU
QU
QU
nR
nR
nR
nR
nR
bL
nR
nR
nR
nR
Zv
Zv
Zv
Zv
Zv
Zv
bL
sC
Si
ly
tM
ly
ly
sC
bL
QV
QV
QV
Ba
VH
QV
QV
QV
nR
nR
nR
nR
nR
nR
nR
nR
nR
nR
nR
nR
nR
nR
nR
nR
QU
QU
QU
QU
QU
QU
QU
QU
QU
"}
(28,1,1) = {"
QU
QU
QU
QU
QU
nR
nR
nR
nR
nR
nR
nR
nR
nR
Zv
nR
nR
bL
Zv
Zv
bL
Zv
bL
sC
ly
cw
ly
ly
Ie
sC
bL
QV
QV
QV
QV
QV
QV
QV
QV
nR
nR
nR
nR
nR
nR
nR
nR
nR
nR
nR
nR
nR
nR
nR
nR
nR
QU
QU
QU
QU
QU
QU
QU
QU
"}
(29,1,1) = {"
QU
QU
QU
QU
QU
nR
nR
nR
nR
nR
nR
nR
nR
Zv
nR
nR
nR
bL
bL
Zv
Zv
bL
bL
sC
sC
Jj
Jj
Jj
sC
sC
bL
sC
QV
Zx
QV
sC
sC
sC
bL
bL
nR
nR
nR
Zv
nR
nR
nR
nR
nR
bL
nR
nR
nR
nR
nR
nR
QU
QU
QU
QU
QU
QU
QU
QU
"}
(30,1,1) = {"
QU
QU
QU
QU
nR
nR
nR
nR
nR
nR
nR
nR
nR
nR
nR
nR
nR
bL
bL
bL
Zv
bL
bL
bL
QV
QV
bL
QV
QV
bL
bL
sC
pF
QV
QV
AT
QV
sC
Zv
nR
nR
nR
nR
nR
nR
nR
nR
nR
nR
nR
nR
nR
nR
nR
nR
nR
QU
QU
QU
QU
QU
QU
QU
QU
"}
(31,1,1) = {"
QU
QU
QU
nR
nR
nR
nR
nR
nR
nR
nR
nR
nR
nR
nR
nR
sC
sC
sC
sC
bL
bL
bL
bL
Zv
Zv
bL
Zv
bL
Zv
Zv
bL
QV
QV
QV
vh
sC
sC
Zv
nR
nR
nR
Zv
nR
Qq
nR
nR
nR
nR
nR
nR
nR
nR
nR
nR
nR
nR
QU
QU
QU
QU
QU
QU
QU
"}
(32,1,1) = {"
QU
QU
QU
nR
nR
nR
nR
nR
nR
nR
nR
nR
nR
nR
nR
QV
sC
ly
ly
sC
sC
Zv
Zv
Zv
Zv
bL
Zv
Zv
bL
bL
Zv
Zv
QV
QV
Zv
QV
QV
nR
nR
nR
bL
nR
nR
nR
nR
nR
nR
nR
nR
bL
nR
nR
nR
nR
nR
nR
nR
QU
QU
QU
QU
QU
QU
QU
"}
(33,1,1) = {"
QU
QU
QU
nR
nR
nR
nR
nR
nR
nR
nR
nR
nR
nR
QV
QV
sC
ly
ly
ly
sC
QV
bL
bL
bL
Zv
Zv
Zv
bL
bL
Zv
Zv
Zv
Zv
Zv
bL
Zv
bL
nR
nR
nR
nR
Zv
nR
nR
nR
nR
nR
nR
nR
nR
nR
nR
nR
nR
nR
nR
QU
QU
QU
QU
QU
QU
QU
"}
(34,1,1) = {"
QU
QU
QU
nR
nR
nR
nR
nR
Zv
Zv
nR
nR
nR
Zv
QV
QV
UY
ly
ly
ly
Xe
Ba
Zv
Zv
Zv
bL
Zv
bL
bL
bL
Zv
Zv
Zv
Dt
sC
Cu
cj
bL
Zv
nR
nR
nR
nR
nR
nR
nR
nR
nR
nR
nR
nR
nR
nR
nR
nR
nR
nR
QU
QU
QU
QU
QU
QU
QU
"}
(35,1,1) = {"
QU
QU
QU
nR
nR
nR
nR
Zv
Zv
Zv
Zv
Zv
Zv
Zv
Zv
QV
UY
ly
pj
ly
sC
bL
Zv
bL
bL
bL
Zv
bL
bL
Zv
bL
bL
Zv
Zv
wa
bL
bL
Zv
nR
nR
bL
nR
Zv
nR
nR
nR
nR
nR
nR
nR
nR
nR
nR
nR
nR
nR
nR
QU
QU
QU
QU
QU
QU
QU
"}
(36,1,1) = {"
QU
QU
nR
nR
nR
nR
nR
Zv
Vq
WB
Zv
Zv
Zv
Zv
QV
QV
UY
Dv
ly
ly
Xe
Ba
bL
Zv
bL
bL
bL
bL
bL
bL
bL
bL
bL
bL
Zv
Zv
Zv
Zv
nR
nR
Zv
nR
nR
nR
Zv
Zv
nR
nR
nR
nR
nR
nR
nR
nR
nR
nR
nR
nR
QU
QU
QU
QU
QU
QU
"}
(37,1,1) = {"
QU
QU
nR
nR
nR
bL
nR
Zv
Zv
Zv
Zv
nR
nR
nR
QV
QV
sC
ly
ly
ly
sC
QV
bL
bL
bL
bL
bL
Zv
Zv
bL
QV
QV
QV
bL
bL
bL
bL
Zv
nR
nR
bL
nR
nR
nR
nR
nR
nR
nR
bL
nR
nR
nR
nR
nR
nR
nR
nR
nR
QU
QU
QU
QU
QU
QU
"}
(38,1,1) = {"
QU
QU
nR
nR
nR
nR
nR
nR
Zv
Zv
nR
nR
nR
nR
nR
QV
sC
ly
ly
sC
sC
bL
bL
bL
bL
bL
bL
bL
Zv
QV
QV
QV
QV
QV
bL
bL
bL
Zv
bL
nR
bL
nR
nR
nR
nR
Qq
nR
nR
nR
nR
nR
nR
nR
nR
bL
nR
nR
nR
QU
QU
QU
QU
QU
QU
"}
(39,1,1) = {"
QU
QU
nR
nR
nR
nR
nR
nR
nR
nR
nR
nR
nR
nR
Zv
nR
sC
sC
sC
sC
bL
bL
bL
Zv
bL
bL
bL
bL
Zv
QV
sC
AG
QV
QV
bL
bL
bL
Zv
Zv
nR
nR
nR
nR
nR
Zv
nR
nR
nR
nR
nR
nR
bL
bL
nR
nR
nR
nR
nR
QU
QU
QU
QU
QU
QU
"}
(40,1,1) = {"
QU
QU
nR
nR
nR
nR
bL
nR
nR
nR
nR
nR
nR
nR
nR
Zv
bL
bL
bL
bL
bL
bL
Zv
bL
Zv
Zv
bL
bL
Zv
QV
wS
QV
QV
QV
bL
Zv
Zv
bL
nR
nR
bL
Zv
Zv
nR
nR
nR
nR
nR
nR
nR
nR
nR
nR
nR
nR
bL
nR
bL
bL
QU
QU
QU
QU
QU
"}
(41,1,1) = {"
QU
QU
nR
nR
nR
bL
bL
nR
nR
nR
Zv
nR
nR
nR
Zv
Zv
bL
Zv
Zv
bL
Zv
bL
Zv
Zv
bL
bL
bL
bL
bL
QV
Zb
QV
QV
QV
bL
bL
Zv
Zv
nR
nR
nR
Zv
nR
nR
nR
Zv
nR
nR
nR
nR
nR
bL
nR
nR
nR
nR
nR
bL
bL
bL
QU
QU
QU
QU
"}
(42,1,1) = {"
QU
QU
bL
nR
nR
bL
nR
nR
bL
nR
nR
nR
nR
nR
nR
bL
bL
bL
bL
bL
bL
bL
bL
Zv
bL
bL
Zv
bL
bL
QV
sC
xb
QV
QV
bL
Zv
bL
Zv
bL
bL
nR
nR
nR
nR
nR
nR
nR
nR
nR
nR
nR
nR
nR
nR
nR
nR
nR
bL
bL
bL
QU
QU
QU
QU
"}
(43,1,1) = {"
QU
QU
nR
nR
nR
bL
nR
bL
nR
nR
nR
nR
nR
Zv
bL
bL
bL
bL
bL
sC
sC
sC
sC
sC
sC
bL
Zv
bL
bL
bL
QV
QV
QV
QV
bL
bL
bL
Zv
bL
nR
Zv
nR
nR
nR
nR
nR
nR
nR
nR
nR
nR
nR
nR
nR
bL
nR
nR
nR
bL
QU
QU
QU
QU
QU
"}
(44,1,1) = {"
QU
QU
nR
nR
nR
bL
bL
nR
nR
bL
nR
nR
nR
Zv
bL
bL
bL
Zv
sC
sC
ly
ly
ly
pj
sC
sC
Zv
bL
bL
bL
QV
QV
QV
QV
Zv
Zv
nR
QV
QV
QV
Zv
nR
nR
nR
nR
nR
Qq
nR
nR
nR
nR
nR
bL
bL
bL
nR
nR
nR
bL
bL
QU
QU
QU
QU
"}
(45,1,1) = {"
QU
QU
nR
nR
nR
bL
nR
bL
nR
nR
nR
nR
bL
bL
bL
bL
bL
bL
sC
Mf
ly
ly
ly
ly
ly
sC
QV
Zv
bL
Zv
bL
QV
QV
bL
Zv
Zv
Rq
QV
QV
QV
nR
nR
nR
nR
nR
nR
Qq
nR
nR
Qq
nR
Qq
nR
nR
nR
nR
nR
nR
nR
bL
QU
QU
QU
QU
"}
(46,1,1) = {"
QU
QU
nR
nR
nR
bL
nR
bL
bL
nR
nR
bL
bL
bL
bL
bL
Zv
bL
sC
ly
ly
ly
ly
ly
ly
Kz
QV
bL
bL
Zv
Zv
Zv
Zv
bL
Zv
Zv
Rq
QV
Nw
QV
QV
nR
nR
Zv
Zv
Zv
Zv
Zv
nR
nR
nR
nR
nR
nR
nR
nR
nR
nR
nR
bL
nR
QU
QU
QU
"}
(47,1,1) = {"
QU
QU
nR
nR
nR
nR
nR
bL
bL
nR
Zv
nR
nR
bL
bL
Zv
Zv
bL
sC
gq
ly
ly
ly
ly
ly
Kz
bL
bL
bL
bL
Zv
bL
Zv
bL
Zv
Zv
Rq
QV
Jb
Jb
Jb
nR
nR
Zv
Zv
Zv
Zv
Zv
Qq
Qq
Zv
nR
nR
nR
nR
nR
nR
nR
nR
nR
bL
QU
QU
QU
"}
(48,1,1) = {"
QU
QU
nR
nR
nR
bL
nR
bL
bL
nR
nR
bL
nR
Zv
bL
bL
Zv
sC
sC
sC
yT
ly
ly
ly
ly
Kz
Kc
bL
bL
Zv
bL
bL
bL
bL
Zv
Zv
Zv
Rq
Rq
Rq
nR
nR
Zv
Zv
Zv
Zv
Zv
Zv
Zv
Zv
Zv
nR
nR
bL
bL
nR
bL
nR
bL
nR
bL
bL
QU
QU
"}
(49,1,1) = {"
QU
QU
nR
nR
nR
nR
nR
nR
bL
nR
Qq
nR
bL
nR
bL
bL
bL
sC
ly
sC
sC
sC
sC
ly
ly
sC
QV
Zv
bL
Zv
bL
bL
bL
bL
Zv
Zv
Zv
Zv
Zv
Zv
Zv
Zv
Zv
Zv
Zv
Zv
Zv
Zv
Zv
Zv
Zv
Zv
Zv
Zv
Zv
Zv
Zv
Zv
bL
bL
bL
bL
QU
QU
"}
(50,1,1) = {"
QU
QU
nR
nR
nR
bL
nR
nR
bL
nR
Qq
nR
nR
nR
Zv
bL
bL
sC
ly
ly
ly
ly
CY
ly
ly
sC
bL
bL
bL
bL
bL
bL
Zv
bL
bL
Zv
Zv
Zv
Zv
Zv
Zv
Zv
Zv
Zv
Zv
Zv
Zv
Zv
Zv
Zv
Zv
Zv
Zv
Zv
Zv
Zv
Zv
Zv
Zv
bL
bL
bL
QU
QU
"}
(51,1,1) = {"
QU
QU
nR
nR
nR
bL
nR
nR
bL
nR
Qq
nR
Zv
nR
Zv
bL
bL
sC
ly
ly
km
ly
sC
sC
sC
sC
Zv
bL
bL
eZ
eZ
eZ
bL
bL
Zv
Zv
Zv
Zv
Zv
Zv
Zv
Zv
Zv
Zv
Zv
Zv
Zv
Zv
Zv
Zv
Zv
Zv
Zv
Zv
Zv
Zv
Zv
Zv
Zv
bL
bL
bL
QU
QU
"}
(52,1,1) = {"
QU
QU
nR
bL
nR
nR
nR
nR
nR
nR
nR
Zv
Zv
Zv
nR
bL
bL
sC
ly
ly
ly
ly
sC
ly
ly
sC
bL
Zv
TM
Zv
Zv
Zv
Zv
bL
Zv
bL
Zv
Rq
Rq
Rq
nR
nR
Zv
Zv
Zv
Zv
Zv
Zv
Zv
Zv
Zv
nR
Qq
Zv
bL
nR
nR
nR
nR
nR
nR
nR
bL
QU
"}
(53,1,1) = {"
QU
QU
nR
nR
nR
nR
nR
nR
nR
nR
bL
nR
nR
nR
Zv
bL
bL
sC
ly
ly
ly
ly
Kz
ly
gi
sC
bL
bL
Ij
Zv
yN
Zv
Zv
bL
bL
bL
Rq
QV
Jb
Jb
Jb
nR
Qq
Zv
Zv
Zv
Zv
Zv
Zv
Qq
nR
Qq
Qq
bL
nR
nR
nR
nR
nR
nR
nR
bL
bL
QU
"}
(54,1,1) = {"
QU
QU
nR
nR
nR
nR
nR
nR
nR
nR
nR
nR
nR
nR
nR
bL
bL
sC
ly
ly
ly
ly
Kz
ly
ly
sC
Zv
bL
TM
dq
Cc
AX
Zv
bL
bL
Zv
Rq
QV
sf
QV
QV
nR
nR
Qq
Zv
Zv
Zv
Zv
nR
nR
nR
nR
nR
nR
nR
nR
bL
nR
nR
nR
nR
nR
QU
QU
"}
(55,1,1) = {"
QU
QU
nR
nR
nR
nR
nR
nR
nR
nR
bL
Zv
nR
nR
bL
bL
bL
sC
sC
ly
ly
tz
Kz
ly
ly
sC
bL
Zv
Zv
Zv
Zv
Zv
bL
bL
Zv
bL
Rq
QV
QV
QV
nR
nR
nR
nR
Qq
nR
Zv
Zv
nR
nR
nR
nR
nR
nR
Zv
nR
nR
bL
nR
nR
nR
nR
QU
QU
"}
(56,1,1) = {"
QU
QU
bL
nR
nR
bL
nR
nR
nR
nR
nR
Zv
nR
nR
bL
bL
bL
bL
sC
sC
ly
ly
sC
eG
ly
sC
bL
bL
bL
Qs
kf
sQ
bL
bL
bL
bL
nR
QV
QV
QV
nR
nR
nR
Qq
nR
nR
Zv
nR
nR
nR
nR
nR
nR
nR
nR
nR
nR
bL
nR
nR
nR
nR
QU
QU
"}
(57,1,1) = {"
QU
QU
bL
nR
nR
nR
nR
nR
nR
nR
nR
nR
Zv
nR
nR
bL
bL
bL
Zv
sC
sC
sC
sC
pE
sC
sC
bL
bL
bL
bL
bL
Zv
bL
bL
bL
bL
bL
bL
bL
nR
nR
Zv
Zv
nR
nR
nR
nR
nR
nR
nR
nR
nR
nR
nR
nR
nR
nR
nR
nR
nR
nR
nR
QU
QU
"}
(58,1,1) = {"
QU
QU
QU
nR
bL
nR
nR
nR
nR
bL
nR
nR
Zv
nR
Zv
Zv
bL
bL
Zv
Zv
Zv
bL
sC
ly
ly
pE
Zv
bL
Zv
bL
bL
bL
Zv
Zv
bL
Zv
bL
bL
bL
Zv
Zv
nR
Zv
nR
nR
Zv
nR
nR
nR
nR
nR
nR
nR
nR
nR
nR
nR
bL
nR
nR
nR
nR
QU
QU
"}
(59,1,1) = {"
QU
QU
QU
nR
nR
nR
nR
bL
bL
nR
bL
nR
nR
nR
Zv
Zv
bL
bL
bL
bL
bL
Zv
sC
sC
sC
sC
Zv
bL
Zv
bL
bL
bL
bL
bL
Zv
Zv
bL
bL
bL
nR
nR
nR
nR
nR
nR
nR
nR
nR
nR
nR
nR
nR
nR
nR
nR
Zv
nR
nR
nR
nR
nR
nR
QU
QU
"}
(60,1,1) = {"
QU
QU
QU
nR
nR
nR
nR
bL
nR
nR
nR
nR
nR
Zv
bL
bL
bL
Zv
bL
bL
bL
bL
Zv
bL
Zv
Zv
Zv
Zv
Zv
bL
bL
bL
Zv
bL
Zv
Zv
bL
Zv
nR
bL
nR
nR
Zv
Zv
Qq
nR
nR
nR
nR
nR
nR
nR
nR
nR
nR
bL
nR
nR
nR
nR
nR
nR
QU
QU
"}
(61,1,1) = {"
QU
QU
QU
QU
nR
bL
nR
nR
nR
bL
nR
nR
nR
Zv
bL
bL
bL
Zv
Zv
bL
bL
bL
bL
Zv
bL
Zv
Zv
bL
Zv
sC
sC
sC
sC
bL
Zv
Zv
bL
bL
nR
nR
nR
nR
nR
nR
nR
Qq
nR
nR
nR
nR
nR
nR
nR
nR
nR
Qq
nR
nR
nR
nR
nR
nR
QU
QU
"}
(62,1,1) = {"
QU
QU
QU
nR
nR
nR
nR
bL
nR
nR
Zv
nR
nR
nR
Zv
Zv
bL
bL
bL
Zv
Zv
bL
bL
bL
Zv
Zv
Zv
sC
sC
sC
Fa
ly
sC
sC
sC
sC
sC
bL
Zv
nR
nR
nR
nR
nR
nR
nR
nR
nR
nR
nR
nR
nR
nR
nR
nR
nR
nR
nR
nR
nR
nR
nR
QU
QU
"}
(63,1,1) = {"
QU
QU
QU
nR
nR
bL
nR
nR
nR
nR
nR
nR
nR
nR
Zv
Zv
Zv
Zv
Zv
Zv
Zv
Zv
bL
bL
bL
Zv
QV
sC
ly
ly
Si
ly
Kz
od
ly
ly
sC
bL
bL
nR
nR
nR
nR
nR
nR
nR
nR
nR
nR
nR
nR
nR
nR
nR
nR
nR
nR
nR
nR
nR
nR
QU
QU
QU
"}
(64,1,1) = {"
QU
QU
QU
nR
bL
nR
nR
nR
nR
nR
nR
bL
nR
nR
nR
bL
bL
Zv
Zv
Zv
Zv
Zv
Zv
Zv
bL
Zv
QV
eI
ly
ly
ly
ly
Kz
ly
ly
ly
sC
bL
bL
nR
nR
nR
nR
nR
nR
nR
nR
nR
nR
nR
nR
nR
nR
nR
nR
nR
nR
nR
nR
nR
nR
nR
QU
QU
"}
(65,1,1) = {"
QU
QU
QU
nR
nR
nR
nR
nR
nR
Zv
nR
nR
nR
nR
nR
Zv
bL
Zv
sC
sC
sC
sC
Zv
Zv
bL
bL
Gk
eI
ly
ly
YK
ly
Kz
ly
VT
ly
sC
Zv
bL
nR
nR
nR
nR
nR
nR
nR
nR
nR
nR
nR
nR
nR
nR
nR
Zv
nR
nR
nR
nR
nR
nR
QU
QU
QU
"}
(66,1,1) = {"
QU
QU
QU
nR
nR
nR
nR
bL
nR
nR
nR
nR
nR
nR
bL
Zv
bL
sC
sC
GD
ly
sC
sC
QV
Zv
bL
QV
sC
ly
EM
ly
sC
sC
ly
ly
ly
sC
Zv
bL
nR
nR
nR
nR
nR
Zv
nR
nR
nR
nR
Zv
nR
nR
Zv
nR
nR
nR
nR
nR
nR
nR
nR
nR
QU
QU
"}
(67,1,1) = {"
QU
QU
QU
nR
QU
nR
nR
nR
nR
nR
nR
nR
nR
nR
nR
Zv
bL
sC
ly
ly
ly
ly
UY
Fh
Zv
bL
bL
sC
sC
ly
ly
sC
ly
ly
ly
sC
sC
bL
bL
bL
nR
nR
nR
nR
nR
Zv
nR
nR
nR
nR
nR
nR
Zv
Zv
nR
nR
nR
nR
nR
QU
nR
QU
QU
QU
"}
(68,1,1) = {"
QU
QU
QU
QU
QU
nR
nR
nR
nR
nR
nR
Zv
nR
nR
nR
bL
Zv
sC
ly
sC
Vm
ly
UY
bL
bL
bL
bL
Zv
sC
sC
sC
sC
ly
ly
ly
sC
Zv
Zv
bL
bL
bL
nR
nR
nR
nR
nR
nR
nR
nR
nR
nR
bL
Zv
Zv
nR
nR
nR
nR
nR
QU
QU
QU
QU
QU
"}
(69,1,1) = {"
QU
QU
QU
QU
nR
nR
nR
bL
nR
nR
nR
nR
nR
bL
nR
bL
bL
sC
EM
ly
ly
ly
UY
QV
bL
Zv
bL
Zv
bL
bL
bL
sC
sC
sC
sC
sC
Zv
bL
bL
bL
bL
nR
nR
Zv
Zv
Zv
nR
nR
nR
nR
bL
nR
Zv
Zv
nR
nR
nR
nR
nR
QU
QU
QU
QU
QU
"}
(70,1,1) = {"
QU
QU
QU
QU
nR
bL
nR
nR
nR
nR
nR
nR
nR
nR
nR
bL
Zv
sC
sC
wT
ly
sC
sC
QV
bL
bL
bL
Zv
bL
bL
bL
bL
bL
bL
bL
Zv
Zv
bL
Zv
bL
bL
bL
bL
nR
nR
Zv
nR
nR
nR
Zv
bL
Zv
nR
nR
nR
nR
nR
nR
QU
QU
QU
QU
QU
QU
"}
(71,1,1) = {"
QU
QU
QU
QU
nR
nR
nR
nR
nR
bL
nR
nR
nR
nR
nR
nR
bL
Zv
sC
sC
sC
sC
Zv
Zv
bL
bL
bL
bL
bL
Zv
bL
bL
bL
bL
bL
bL
Zv
Zv
Zv
nR
nR
nR
nR
Qq
Zv
nR
Zv
nR
nR
nR
bL
nR
Zv
nR
nR
nR
nR
QU
QU
QU
QU
QU
QU
QU
"}
(72,1,1) = {"
QU
QU
QU
QU
QU
nR
nR
nR
nR
nR
nR
nR
nR
nR
nR
nR
bL
Zv
Zv
Zv
bL
bL
bL
Zv
Zv
bL
bL
Zv
Zv
Zv
bL
bL
bL
bL
Zv
bL
bL
Zv
Zv
nR
nR
nR
nR
Zv
nR
nR
nR
nR
nR
bL
nR
nR
Zv
nR
nR
nR
nR
QU
QU
QU
QU
QU
QU
QU
"}
(73,1,1) = {"
QU
QU
QU
QU
QU
QU
QU
nR
nR
nR
nR
nR
nR
nR
nR
nR
bL
Zv
bL
Zv
bL
bL
Zv
Zv
bL
Zv
Zv
Zv
Zv
Zv
Zv
bL
bL
Zv
bL
bL
bL
bL
bL
bL
nR
nR
nR
Zv
nR
nR
nR
nR
Zv
nR
nR
nR
Zv
nR
nR
nR
nR
QU
QU
QU
QU
QU
QU
QU
"}
(74,1,1) = {"
QU
QU
QU
QU
QU
QU
nR
nR
nR
nR
nR
nR
nR
nR
nR
nR
nR
nR
bL
bL
Zv
bL
Zv
bL
Zv
Zv
Zv
Zv
Zv
Zv
Zv
Zv
bL
bL
Zv
Zv
Zv
Zv
Zv
bL
nR
nR
nR
nR
nR
nR
nR
nR
nR
nR
nR
nR
Zv
nR
nR
nR
nR
QU
QU
QU
QU
QU
QU
QU
"}
(75,1,1) = {"
QU
QU
QU
QU
QU
QU
nR
bL
nR
nR
nR
nR
nR
nR
nR
nR
nR
bL
bL
Zv
Zv
bL
bL
bL
Zv
Zv
Zv
Zv
bL
sC
QV
QJ
QV
QV
sC
bL
bL
Zv
Zv
nR
nR
nR
nR
nR
nR
nR
nR
nR
Zv
nR
bL
nR
Zv
Zv
nR
nR
QU
nR
QU
QU
QU
QU
QU
QU
"}
(76,1,1) = {"
QU
QU
QU
QU
QU
QU
nR
nR
nR
nR
nR
nR
bL
nR
bL
nR
nR
Zv
nR
Zv
bL
bL
bL
bL
bL
bL
Zv
bL
sC
sC
Jj
Jj
Jj
Jj
sC
sC
bL
bL
bL
nR
nR
nR
nR
nR
nR
nR
nR
nR
nR
nR
Zv
nR
Zv
nR
nR
nR
QU
QU
QU
QU
QU
QU
QU
QU
"}
(77,1,1) = {"
QU
QU
QU
QU
QU
QU
bL
bL
bL
nR
nR
nR
nR
nR
nR
nR
nR
nR
nR
nR
Qq
Zv
bL
bL
bL
sC
QV
QJ
sC
ns
ly
ly
ly
ly
ly
sC
QV
QJ
sC
nR
nR
nR
nR
nR
nR
Qq
nR
nR
nR
nR
Zv
Zv
nR
nR
nR
nR
QU
QU
QU
QU
QU
QU
QU
QU
"}
(78,1,1) = {"
QU
QU
QU
QU
QU
QU
bL
nR
nR
bL
nR
nR
bL
nR
nR
nR
nR
nR
bL
nR
bL
bL
bL
Zv
Zv
sC
Jj
Jj
sC
ly
ly
ly
ly
ly
ly
sC
Jj
Jj
sC
nR
nR
nR
nR
Zv
nR
nR
nR
Zv
nR
Qq
Zv
nR
nR
nR
nR
nR
nR
QU
QU
QU
QU
QU
QU
QU
"}
(79,1,1) = {"
QU
QU
QU
QU
QU
QU
bL
bL
nR
nR
nR
nR
nR
nR
nR
nR
nR
nR
bL
Zv
bL
bL
Zv
Zv
bL
sC
ly
ly
sC
ly
IJ
ly
ly
ly
ly
sC
ly
ly
sC
nR
nR
nR
nR
nR
Zv
nR
nR
nR
nR
Zv
Zv
nR
nR
nR
nR
nR
QU
QU
QU
QU
QU
QU
QU
QU
"}
(80,1,1) = {"
QU
QU
QU
QU
QU
QU
bL
nR
nR
nR
bL
nR
nR
nR
nR
nR
bL
nR
nR
nR
bL
bL
bL
bL
bL
sC
ly
ly
sC
ly
sC
nS
CY
sC
ly
sC
ly
ly
sC
nR
nR
Zv
nR
Zv
nR
nR
nR
Zv
nR
Zv
nR
nR
nR
nR
nR
QU
QU
QU
QU
QU
QU
QU
QU
QU
"}
(81,1,1) = {"
QU
QU
QU
QU
QU
nR
nR
nR
nR
nR
nR
nR
nR
nR
nR
nR
nR
nR
nR
nR
nR
nR
bL
bL
bL
sC
ly
ly
ly
ly
nS
ly
ly
nS
ly
ly
ly
ly
sC
nR
nR
nR
nR
Zv
nR
nR
nR
nR
nR
Qq
nR
nR
nR
nR
nR
QU
QU
QU
QU
QU
QU
QU
QU
QU
"}
(82,1,1) = {"
QU
QU
QU
QU
QU
QU
nR
nR
nR
nR
nR
nR
nR
nR
nR
nR
nR
bL
nR
nR
nR
nR
nR
bL
bL
sC
sC
ly
ly
sC
sC
BT
ly
sC
sC
ly
ly
sC
sC
nR
nR
nR
Zv
nR
nR
nR
nR
nR
Zv
bL
nR
nR
nR
nR
QU
nR
QU
QU
QU
QU
QU
QU
QU
QU
"}
(83,1,1) = {"
QU
QU
QU
QU
QU
QU
nR
nR
nR
nR
nR
nR
nR
nR
nR
nR
bL
nR
nR
nR
bL
nR
nR
bL
bL
Zv
sC
ly
sC
sC
nS
wT
ly
nS
sC
sC
ly
sC
nR
nR
nR
nR
nR
nR
nR
nR
nR
nR
Zv
Qq
nR
nR
nR
nR
QU
QU
QU
QU
QU
QU
QU
QU
QU
QU
"}
(84,1,1) = {"
QU
QU
QU
QU
QU
QU
nR
nR
nR
nR
nR
nR
nR
nR
nR
nR
nR
nR
nR
nR
Zv
nR
Zv
nR
Zv
Zv
sC
sC
sC
bL
nS
nS
nS
nS
Zv
sC
sC
sC
nR
nR
Zv
nR
nR
nR
nR
nR
nR
nR
nR
nR
Zv
nR
nR
nR
QU
QU
QU
QU
QU
QU
QU
QU
QU
QU
"}
(85,1,1) = {"
QU
QU
QU
QU
QU
QU
bL
nR
nR
nR
nR
nR
nR
nR
nR
nR
nR
nR
nR
nR
bL
nR
Zv
nR
nR
nR
nR
nR
nR
nR
nR
nR
nR
nR
nR
nR
nR
Qq
nR
nR
Zv
nR
nR
nR
nR
nR
nR
nR
nR
Zv
nR
nR
nR
nR
QU
QU
QU
QU
QU
QU
QU
QU
QU
QU
"}
(86,1,1) = {"
QU
QU
QU
QU
QU
QU
QU
nR
bL
bL
nR
bL
nR
nR
nR
nR
nR
nR
nR
nR
nR
nR
nR
nR
nR
nR
nR
nR
nR
Zv
nR
nR
nR
nR
nR
Zv
nR
Qq
nR
nR
Zv
nR
nR
nR
nR
Zv
Zv
nR
nR
nR
nR
nR
nR
QU
QU
QU
QU
QU
QU
QU
QU
QU
QU
QU
"}
(87,1,1) = {"
QU
QU
QU
QU
QU
QU
QU
nR
nR
bL
nR
bL
nR
nR
nR
bL
nR
nR
nR
nR
nR
nR
nR
nR
nR
nR
nR
nR
nR
nR
nR
nR
Zv
nR
nR
nR
nR
nR
nR
nR
Zv
nR
Zv
nR
nR
Zv
nR
nR
nR
nR
nR
nR
nR
QU
QU
QU
QU
QU
QU
QU
QU
QU
QU
QU
"}
(88,1,1) = {"
QU
QU
QU
QU
QU
QU
QU
QU
nR
nR
nR
nR
nR
nR
nR
nR
bL
nR
nR
nR
nR
nR
nR
nR
nR
nR
nR
nR
nR
nR
bL
nR
nR
nR
nR
nR
nR
nR
bL
Zv
nR
nR
Zv
nR
nR
Zv
nR
nR
Qq
nR
nR
nR
QU
QU
QU
QU
QU
QU
QU
QU
QU
QU
QU
QU
"}
(89,1,1) = {"
QU
QU
QU
QU
QU
QU
QU
QU
nR
nR
nR
nR
nR
nR
nR
nR
nR
nR
nR
nR
nR
nR
nR
bL
nR
nR
nR
nR
nR
nR
nR
nR
nR
Qq
nR
nR
bL
nR
nR
Zv
Zv
nR
nR
nR
nR
Zv
nR
nR
nR
nR
nR
nR
QU
QU
QU
QU
QU
QU
QU
QU
QU
QU
QU
QU
"}
(90,1,1) = {"
QU
QU
QU
QU
QU
QU
QU
QU
QU
nR
nR
nR
Zv
bL
nR
nR
nR
bL
nR
nR
bL
Qq
nR
nR
bL
nR
nR
nR
nR
nR
bL
nR
nR
Qq
nR
nR
bL
Zv
nR
Zv
nR
nR
nR
nR
nR
Zv
nR
nR
Qq
nR
nR
QU
QU
QU
QU
QU
QU
QU
QU
QU
QU
QU
QU
QU
"}
(91,1,1) = {"
QU
QU
QU
QU
QU
QU
QU
QU
QU
QU
nR
nR
nR
nR
bL
nR
bL
nR
nR
nR
nR
nR
nR
nR
nR
Zv
nR
nR
nR
Zv
nR
nR
nR
nR
nR
nR
Zv
Zv
Zv
nR
nR
nR
nR
nR
nR
Zv
nR
nR
Zv
nR
nR
QU
QU
QU
QU
QU
QU
QU
QU
QU
QU
QU
QU
QU
"}
(92,1,1) = {"
QU
QU
QU
QU
QU
QU
QU
QU
QU
QU
nR
nR
bL
nR
nR
nR
nR
nR
nR
nR
nR
nR
nR
nR
nR
Zv
nR
nR
bL
Zv
nR
nR
nR
Zv
nR
nR
Zv
nR
Zv
bL
nR
Zv
Qq
nR
Zv
bL
Zv
nR
Zv
QU
QU
QU
QU
QU
QU
QU
QU
QU
QU
QU
QU
QU
QU
QU
"}
(93,1,1) = {"
QU
QU
QU
QU
QU
QU
QU
QU
QU
QU
QU
nR
nR
bL
nR
nR
nR
nR
nR
nR
nR
bL
nR
nR
nR
nR
nR
nR
nR
nR
nR
nR
nR
Zv
nR
bL
Zv
nR
nR
nR
nR
nR
nR
nR
nR
bL
bL
QU
QU
QU
QU
QU
QU
QU
QU
QU
QU
QU
QU
QU
QU
QU
QU
QU
"}
(94,1,1) = {"
QU
QU
QU
QU
QU
QU
QU
QU
QU
QU
QU
bL
nR
nR
bL
nR
nR
nR
nR
bL
nR
bL
nR
nR
nR
nR
Zv
nR
Qq
nR
bL
nR
nR
Zv
Qq
bL
Zv
nR
nR
bL
nR
nR
Qq
bL
nR
bL
bL
QU
QU
QU
QU
QU
QU
QU
QU
QU
QU
QU
QU
QU
QU
QU
QU
QU
"}
(95,1,1) = {"
QU
QU
QU
QU
QU
QU
QU
QU
QU
QU
QU
QU
nR
nR
nR
nR
nR
nR
nR
nR
bL
nR
Zv
nR
nR
nR
nR
nR
nR
Qq
nR
bL
nR
nR
nR
Zv
nR
nR
nR
nR
nR
nR
Qq
nR
nR
bL
QU
QU
QU
QU
QU
QU
QU
QU
QU
QU
QU
QU
QU
QU
QU
QU
QU
QU
"}
(96,1,1) = {"
QU
QU
QU
QU
QU
QU
QU
QU
QU
QU
QU
QU
QU
nR
nR
nR
nR
nR
bL
nR
nR
bL
Qq
bL
nR
nR
nR
nR
nR
Zv
nR
nR
nR
nR
Zv
nR
Zv
nR
nR
nR
nR
Qq
bL
bL
QU
QU
QU
QU
QU
QU
QU
QU
QU
QU
QU
QU
QU
QU
QU
QU
QU
QU
QU
QU
"}
(97,1,1) = {"
QU
QU
QU
QU
QU
QU
QU
QU
QU
QU
QU
QU
QU
bL
nR
nR
nR
nR
nR
nR
nR
nR
bL
Zv
bL
nR
Zv
nR
Zv
nR
nR
nR
nR
nR
nR
Zv
nR
nR
Zv
Zv
bL
nR
Zv
QU
QU
QU
QU
QU
QU
QU
QU
QU
QU
QU
QU
QU
QU
QU
QU
QU
QU
QU
QU
QU
"}
(98,1,1) = {"
QU
QU
QU
QU
QU
QU
QU
QU
QU
QU
QU
QU
QU
QU
QU
bL
nR
nR
nR
nR
nR
nR
nR
nR
bL
nR
bL
Qq
nR
nR
Qq
nR
nR
Zv
Zv
nR
nR
nR
nR
bL
bL
Zv
Zv
QU
QU
QU
QU
QU
QU
QU
QU
QU
QU
QU
QU
QU
QU
QU
QU
QU
QU
QU
QU
QU
"}
(99,1,1) = {"
QU
QU
QU
QU
QU
QU
QU
QU
QU
QU
QU
QU
QU
QU
QU
QU
QU
bL
nR
nR
nR
nR
nR
nR
nR
Zv
nR
Zv
nR
nR
Zv
Zv
nR
nR
nR
nR
nR
bL
bL
bL
bL
bL
QU
QU
QU
QU
QU
QU
QU
QU
QU
QU
QU
QU
QU
QU
QU
QU
QU
QU
QU
QU
QU
QU
"}
(100,1,1) = {"
QU
QU
QU
QU
QU
QU
QU
QU
QU
QU
QU
QU
QU
QU
QU
QU
QU
QU
bL
nR
nR
bL
nR
nR
nR
bL
bL
bL
nR
Zv
nR
nR
nR
nR
Qq
nR
nR
nR
bL
Zv
QU
QU
QU
QU
QU
QU
QU
QU
QU
QU
QU
QU
QU
QU
QU
QU
QU
QU
QU
QU
QU
QU
QU
QU
"}
(101,1,1) = {"
QU
QU
QU
QU
QU
QU
QU
QU
QU
QU
QU
QU
QU
QU
QU
QU
QU
QU
QU
nR
nR
bL
nR
nR
bL
bL
bL
bL
nR
bL
nR
nR
nR
nR
Qq
Qq
bL
bL
bL
bL
Zv
QU
QU
QU
QU
QU
QU
QU
QU
QU
QU
QU
QU
QU
QU
QU
QU
QU
QU
QU
QU
QU
QU
QU
"}
(102,1,1) = {"
QU
QU
QU
QU
QU
QU
QU
QU
QU
QU
QU
QU
QU
QU
QU
QU
QU
QU
QU
QU
QU
QU
QU
nR
nR
bL
nR
bL
nR
bL
bL
nR
QU
nR
QU
bL
QU
QU
bL
QU
QU
QU
QU
QU
QU
QU
QU
QU
QU
QU
QU
QU
QU
QU
QU
QU
QU
QU
QU
QU
QU
QU
QU
QU
"}
(103,1,1) = {"
QU
QU
QU
QU
QU
QU
QU
QU
QU
QU
QU
QU
QU
QU
QU
QU
QU
QU
QU
QU
QU
QU
QU
QU
QU
QU
QU
QU
QU
QU
QU
QU
QU
QU
QU
QU
QU
QU
QU
QU
QU
QU
QU
QU
QU
QU
QU
QU
QU
QU
QU
QU
QU
QU
QU
QU
QU
QU
QU
QU
QU
QU
QU
QU
"}
