//MAP CONVERTED BY dmm2tgm.py THIS HEADER COMMENT PREVENTS RECONVERSION, DO NOT REMOVE
"ae" = (
/obj/structure/crate_shelf,
/obj/effect/turf_decal/trimline/opaque/yellow/line{
	dir = 4
	},
/obj/effect/turf_decal/trimline/opaque/yellow/line{
	dir = 8
	},
/turf/open/floor/plasteel/mono,
/area/space)
"am" = (
/obj/machinery/atmospherics/components/binary/pump/layer2{
	dir = 8;
	name = "scrubber exhaust pump"
	},
/obj/machinery/atmospherics/components/binary/pump/layer4{
	name = "air refill pump";
	dir = 8
	},
/obj/structure/cable{
	icon_state = "2-8"
	},
/obj/structure/cable{
	icon_state = "4-8"
	},
/obj/structure/catwalk/over/plated_catwalk/dark,
/turf/open/floor/plating,
/area/space)
"ao" = (
/obj/structure/table,
/obj/item/paper_bin{
	pixel_y = 4;
	pixel_x = -5
	},
/obj/item/pen/fourcolor{
	pixel_y = 6;
	pixel_x = -5
	},
/obj/item/folder/red{
	pixel_x = 9;
	pixel_y = 0
	},
/obj/item/folder/blue{
	pixel_x = 8;
	pixel_y = -3
	},
/obj/machinery/door/firedoor/border_only{
	dir = 1
	},
/obj/machinery/door/firedoor/border_only,
/obj/machinery/jukebox/boombox{
	pixel_y = 9;
	pixel_x = 11
	},
/obj/effect/turf_decal/siding/wideplating{
	dir = 9
	},
/turf/open/floor/plasteel/mono,
/area/space)
"av" = (
/obj/machinery/computer/helm{
	dir = 8
	},
/obj/effect/turf_decal/siding/wideplating{
	dir = 6
	},
/turf/open/floor/plasteel/mono,
/area/space)
"bz" = (
/obj/machinery/door/firedoor/border_only{
	dir = 8
	},
/obj/machinery/door/firedoor/border_only{
	dir = 4
	},
/obj/machinery/door/airlock/external/glass{
	dir = 4
	},
/turf/open/floor/plasteel/patterned/ridged,
/area/space)
"bH" = (
/obj/effect/turf_decal/industrial/warning{
	dir = 1
	},
/obj/effect/turf_decal/trimline/opaque/yellow/line,
/turf/open/floor/plasteel/mono,
/area/space)
"cO" = (
/obj/structure/catwalk/over/plated_catwalk,
/obj/structure/cable{
	icon_state = "4-8"
	},
/turf/open/floor/plating,
/area/space)
"cP" = (
/obj/machinery/atmospherics/pipe/simple/supply/hidden/layer4{
	dir = 4
	},
/obj/machinery/atmospherics/pipe/simple/scrubbers/hidden/layer2{
	dir = 8
	},
/obj/effect/turf_decal/borderfloor,
/turf/open/floor/plasteel/mono,
/area/space)
"di" = (
/obj/structure/grille,
/obj/structure/window/reinforced/fulltile/shuttle,
/obj/machinery/door/firedoor/border_only{
	dir = 8
	},
/obj/machinery/door/firedoor/border_only{
	dir = 1
	},
/turf/open/floor/plating,
/area/space)
"do" = (
/obj/effect/turf_decal/box/corners{
	dir = 8
	},
/turf/open/floor/plasteel/patterned/ridged,
/area/space)
"dx" = (
/obj/structure/catwalk/over/plated_catwalk,
/obj/structure/cable{
	icon_state = "1-4"
	},
/turf/open/floor/plating,
/area/space)
"fr" = (
/obj/effect/turf_decal/borderfloor{
	dir = 1
	},
/turf/open/floor/plasteel/mono,
/area/space)
"ft" = (
/obj/structure/window/reinforced/fulltile/shuttle,
/obj/machinery/door/firedoor/border_only{
	dir = 4
	},
/obj/machinery/door/firedoor/border_only{
	dir = 8
	},
/obj/structure/grille,
/turf/open/floor/plating,
/area/space)
"gc" = (
/obj/structure/catwalk/over/plated_catwalk,
/obj/structure/cable{
	icon_state = "2-8"
	},
/obj/structure/cable{
	icon_state = "2-4"
	},
/obj/machinery/atmospherics/pipe/simple/scrubbers/hidden/layer2{
	dir = 6
	},
/obj/machinery/atmospherics/pipe/simple/supply/hidden/layer4{
	dir = 6
	},
/turf/open/floor/plating,
/area/space)
"go" = (
/obj/machinery/portable_atmospherics/pump,
/obj/machinery/atmospherics/components/unary/portables_connector/layer4,
/turf/open/floor/plasteel/tech/grid,
/area/space)
"gu" = (
/obj/structure/catwalk/over/plated_catwalk,
/obj/structure/cable{
	icon_state = "2-8"
	},
/turf/open/floor/plating,
/area/space)
"gv" = (
/turf/closed/wall/mineral/plastitanium/nodiagonal,
/area/space)
"hd" = (
/obj/structure/window/reinforced/fulltile/shuttle,
/obj/machinery/door/firedoor/border_only{
	dir = 8
	},
/obj/machinery/door/firedoor/border_only{
	dir = 1
	},
/obj/structure/grille,
/turf/open/floor/plating,
/area/space)
"jc" = (
/obj/structure/safe{
	locked = 0
	},
/obj/item/spacecash/bundle/loadsamoney,
/obj/item/spacecash/bundle/loadsamoney,
/obj/item/storage/bag/money,
/obj/item/card/bank,
/obj/effect/turf_decal/siding/wideplating{
	dir = 8
	},
/turf/open/floor/plasteel/patterned/ridged,
/area/space)
"jj" = (
/obj/machinery/computer/cargo/express{
	dir = 4
	},
/obj/effect/turf_decal/siding/wideplating{
	dir = 10
	},
/turf/open/floor/plasteel/mono,
/area/space)
"jY" = (
/obj/structure/catwalk/over/plated_catwalk/dark,
/obj/structure/cable{
	icon_state = "4-8"
	},
/turf/open/floor/plating,
/area/space)
"mB" = (
/obj/structure/cable{
	icon_state = "2-4"
	},
/obj/structure/cable{
	icon_state = "2-8"
	},
/obj/structure/catwalk/over/plated_catwalk,
/turf/open/floor/plating,
/area/space)
"nQ" = (
/obj/effect/turf_decal/industrial/warning/corner,
/turf/open/floor/engine/hull,
/area/space)
"ob" = (
/obj/structure/rack,
/obj/effect/turf_decal/siding/wideplating/end{
	dir = 1
	},
/turf/open/floor/plasteel/patterned,
/area/space)
"oq" = (
/obj/effect/turf_decal/box/corners{
	dir = 1
	},
/obj/structure/closet/crate,
/turf/open/floor/plasteel/patterned/ridged,
/area/space)
"oL" = (
/obj/effect/turf_decal/industrial/warning/corner{
	dir = 8
	},
/turf/open/floor/engine/hull,
/area/space)
"oR" = (
/obj/structure/catwalk/over/plated_catwalk,
/obj/structure/cable{
	icon_state = "1-2"
	},
/obj/machinery/door/firedoor/border_only{
	dir = 1
	},
/obj/machinery/door/firedoor/border_only,
/obj/machinery/atmospherics/pipe/simple/scrubbers/hidden/layer2,
/obj/machinery/atmospherics/pipe/simple/supply/hidden/layer4,
/obj/machinery/door/airlock/glass,
/turf/open/floor/plating,
/area/space)
"pn" = (
/obj/machinery/power/smes/shuttle/precharged{
	dir = 1
	},
/obj/structure/catwalk/over/plated_catwalk/dark,
/obj/structure/cable/cyan{
	icon_state = "0-2"
	},
/obj/structure/window/reinforced,
/obj/machinery/door/firedoor/border_only{
	dir = 1
	},
/obj/machinery/door/firedoor/border_only,
/turf/open/floor/plating,
/area/space)
"pT" = (
/obj/structure/sink{
	pixel_y = 25
	},
/turf/open/floor/plasteel/tech/grid,
/area/space)
"pW" = (
/obj/machinery/autolathe/hacked,
/obj/effect/turf_decal/trimline/opaque/yellow/line,
/obj/effect/turf_decal/trimline/opaque/yellow/line{
	dir = 1
	},
/turf/open/floor/plasteel/mono,
/area/space)
"qg" = (
/obj/machinery/computer/bank_machine{
	dir = 8
	},
/obj/effect/turf_decal/siding/wideplating{
	dir = 9
	},
/turf/open/floor/plasteel/patterned/ridged,
/area/space)
"sj" = (
/obj/structure/rack,
/obj/effect/turf_decal/siding/wideplating{
	dir = 8
	},
/turf/open/floor/plasteel/patterned,
/area/space)
"sn" = (
/obj/effect/turf_decal/borderfloor,
/obj/structure/rack,
/obj/effect/turf_decal/siding/wideplating/end,
/turf/open/floor/plasteel/patterned,
/area/space)
"sG" = (
/obj/machinery/atmospherics/pipe/simple/supply/hidden/layer4{
	dir = 4
	},
/obj/machinery/atmospherics/pipe/simple/scrubbers/hidden/layer2{
	dir = 9
	},
/obj/effect/turf_decal/borderfloor,
/turf/open/floor/plasteel/mono,
/area/space)
"sR" = (
/obj/structure/closet/crate,
/obj/effect/turf_decal/box/corners,
/turf/open/floor/plasteel/patterned/ridged,
/area/space)
"sZ" = (
/obj/structure/cable{
	icon_state = "2-4"
	},
/obj/structure/cable{
	icon_state = "4-8"
	},
/obj/structure/catwalk/over/plated_catwalk/dark,
/turf/open/floor/plating,
/area/space)
"th" = (
/obj/machinery/power/port_gen/pacman/super,
/obj/structure/catwalk/over/plated_catwalk,
/obj/structure/cable/yellow{
	icon_state = "0-8"
	},
/turf/open/floor/plating,
/area/space)
"uh" = (
/obj/effect/turf_decal/borderfloor,
/turf/open/floor/plasteel/mono,
/area/space)
"uz" = (
/obj/machinery/door/window/westleft,
/obj/machinery/portable_atmospherics/canister/air,
/obj/machinery/atmospherics/components/unary/portables_connector/layer4{
	dir = 8
	},
/turf/open/floor/plasteel/patterned/ridged,
/area/space)
"uT" = (
/obj/machinery/portable_atmospherics/scrubber,
/obj/machinery/atmospherics/components/unary/portables_connector/layer2,
/turf/open/floor/plasteel/tech/grid,
/area/space)
"vC" = (
/obj/structure/rack,
/obj/effect/turf_decal/siding/wideplating{
	dir = 4
	},
/obj/effect/turf_decal/siding/wideplating{
	dir = 8
	},
/turf/open/floor/plasteel/patterned,
/area/space)
"vY" = (
/obj/machinery/vending/coffee,
/turf/open/floor/plasteel/patterned/ridged,
/area/space)
"wc" = (
/obj/structure/cable{
	icon_state = "1-8"
	},
/obj/machinery/atmospherics/pipe/simple/scrubbers/hidden/layer2{
	dir = 5
	},
/obj/machinery/atmospherics/pipe/simple/supply/hidden/layer4{
	dir = 5
	},
/obj/structure/cable{
	icon_state = "4-8"
	},
/obj/structure/catwalk/over/plated_catwalk,
/turf/open/floor/plating,
/area/space)
"wq" = (
/obj/machinery/door/firedoor/border_only{
	dir = 8
	},
/obj/machinery/door/firedoor/border_only{
	dir = 4
	},
/obj/structure/catwalk/over/plated_catwalk/dark,
/obj/structure/cable{
	icon_state = "4-8"
	},
/obj/machinery/door/airlock/maintenance_hatch{
	dir = 8
	},
/turf/open/floor/plating,
/area/space)
"yQ" = (
/obj/structure/table,
/obj/machinery/paystand{
	pixel_y = 7;
	pixel_x = 1
	},
/obj/machinery/door/firedoor/border_only{
	dir = 1
	},
/obj/machinery/door/firedoor/border_only,
/obj/effect/turf_decal/siding/wideplating{
	dir = 5
	},
/turf/open/floor/plasteel/mono,
/area/space)
"Ba" = (
/obj/machinery/power/apc/auto_name/directional/south,
/obj/structure/cable{
	icon_state = "1-8"
	},
/obj/structure/cable{
	icon_state = "0-8"
	},
/obj/structure/catwalk/over/plated_catwalk,
/turf/open/floor/plating,
/area/space)
"Cz" = (
/obj/structure/janitorialcart,
/obj/item/mop,
/obj/item/storage/bag/trash,
/obj/item/reagent_containers/glass/bucket{
	pixel_x = 8
	},
/turf/open/floor/plasteel/tech/grid,
/area/space)
"CO" = (
/obj/effect/turf_decal/box/corners{
	dir = 4
	},
/turf/open/floor/plasteel/patterned/ridged,
/area/space)
"Dw" = (
/obj/machinery/suit_storage_unit/inherit,
/obj/item/clothing/suit/space/hardsuit/carp,
/obj/item/clothing/mask/gas/carp,
/obj/item/tank/internals/emergency_oxygen/double,
/obj/effect/turf_decal/siding/wideplating{
	dir = 5
	},
/turf/open/floor/plasteel/patterned/ridged,
/area/space)
"DB" = (
/obj/structure/chair/comfy/shuttle{
	dir = 1
	},
/obj/effect/turf_decal/siding/wideplating,
/turf/open/floor/plasteel/mono,
/area/space)
"DS" = (
/obj/machinery/portable_atmospherics/canister,
/obj/machinery/atmospherics/components/unary/portables_connector/layer2,
/obj/machinery/door/window/southright,
/obj/structure/window/reinforced{
	dir = 8
	},
/turf/open/floor/plasteel/patterned/ridged,
/area/space)
"DV" = (
/obj/structure/window/reinforced/fulltile/shuttle,
/obj/machinery/door/firedoor/border_only{
	dir = 4
	},
/obj/structure/grille,
/obj/machinery/door/firedoor/border_only{
	dir = 1
	},
/turf/open/floor/plating,
/area/space)
"DW" = (
/obj/structure/table,
/obj/item/scanner_wand{
	pixel_x = 7;
	pixel_y = 4
	},
/obj/item/price_tagger{
	pixel_x = 15;
	pixel_y = 0
	},
/obj/item/table_bell{
	pixel_y = 10;
	pixel_x = -6
	},
/obj/machinery/door/firedoor/border_only{
	dir = 1
	},
/obj/machinery/door/firedoor/border_only,
/obj/effect/turf_decal/siding/wideplating{
	dir = 1
	},
/obj/item/hand_labeler{
	pixel_x = -13
	},
/turf/open/floor/plasteel/mono,
/area/space)
"EB" = (
/obj/machinery/power/smes/engineering,
/obj/structure/catwalk/over/plated_catwalk,
/obj/structure/cable,
/turf/open/floor/plating,
/area/space)
"Ff" = (
/obj/structure/toilet{
	pixel_y = 14
	},
/turf/open/floor/plasteel/tech/grid,
/area/space)
"Fs" = (
/obj/structure/catwalk/over/plated_catwalk,
/obj/structure/cable{
	icon_state = "2-4"
	},
/turf/open/floor/plating,
/area/space)
"Gr" = (
/obj/machinery/power/smes/shuttle/precharged{
	dir = 1
	},
/obj/structure/catwalk/over/plated_catwalk/dark,
/obj/structure/cable/cyan{
	icon_state = "0-2"
	},
/obj/machinery/door/firedoor/border_only,
/obj/structure/window/reinforced,
/obj/machinery/door/firedoor/border_only{
	dir = 1
	},
/turf/open/floor/plating,
/area/space)
"HE" = (
/obj/structure/catwalk/over/plated_catwalk,
/obj/structure/cable/yellow{
	icon_state = "0-4"
	},
/obj/machinery/power/terminal{
	dir = 8
	},
/turf/open/floor/plating,
/area/space)
"IK" = (
/obj/machinery/space_heater,
/turf/open/floor/plasteel/tech/grid,
/area/space)
"IR" = (
/obj/structure/window/reinforced/fulltile/shuttle,
/obj/machinery/door/firedoor/border_only{
	dir = 4
	},
/obj/machinery/door/firedoor/border_only{
	dir = 1
	},
/obj/structure/grille,
/turf/open/floor/plating,
/area/space)
"Jl" = (
/obj/structure/catwalk/over/plated_catwalk/dark,
/obj/machinery/atmospherics/pipe/simple/scrubbers/hidden/layer2{
	dir = 9
	},
/obj/machinery/power/terminal,
/obj/structure/cable{
	icon_state = "0-8"
	},
/turf/open/floor/plating,
/area/space)
"JT" = (
/obj/structure/catwalk/over/plated_catwalk/dark,
/obj/machinery/atmospherics/pipe/simple/supply/hidden/layer4{
	dir = 9
	},
/obj/machinery/atmospherics/pipe/simple/scrubbers/hidden/layer2{
	dir = 8
	},
/obj/structure/cable{
	icon_state = "4-8"
	},
/turf/open/floor/plating,
/area/space)
"Kf" = (
/turf/open/space/basic,
/area/space)
"Lm" = (
/obj/machinery/door/firedoor/border_only,
/obj/machinery/door/firedoor/border_only{
	dir = 1
	},
/turf/open/floor/plasteel/patterned/ridged,
/area/space)
"Lo" = (
/obj/structure/window/reinforced/fulltile/shuttle,
/obj/machinery/door/firedoor/border_only{
	dir = 8
	},
/obj/machinery/door/firedoor/border_only,
/obj/structure/grille,
/turf/open/floor/plating,
/area/space)
"Lt" = (
/obj/structure/rack,
/obj/effect/turf_decal/siding/wideplating/end,
/turf/open/floor/plasteel/patterned,
/area/space)
"LE" = (
/obj/effect/turf_decal/industrial/warning{
	dir = 8
	},
/obj/effect/turf_decal/siding/wideplating{
	dir = 4
	},
/turf/open/floor/plasteel/patterned,
/area/space)
"Oa" = (
/obj/effect/turf_decal/industrial/warning,
/turf/open/floor/engine/hull,
/area/space)
"Or" = (
/obj/structure/catwalk/over/plated_catwalk,
/obj/structure/cable{
	icon_state = "1-2"
	},
/obj/machinery/atmospherics/pipe/simple/scrubbers/hidden/layer2,
/obj/machinery/atmospherics/pipe/simple/supply/hidden/layer4,
/turf/open/floor/plating,
/area/space)
"OA" = (
/obj/structure/window/reinforced/fulltile/shuttle,
/obj/structure/grille,
/obj/machinery/door/firedoor/border_only{
	dir = 1
	},
/obj/machinery/door/firedoor/border_only{
	dir = 4
	},
/turf/open/floor/plating,
/area/space)
"PM" = (
/obj/structure/cable{
	icon_state = "1-2"
	},
/obj/structure/catwalk/over/plated_catwalk,
/turf/open/floor/plating,
/area/space)
"PY" = (
/obj/machinery/door/firedoor/border_only{
	dir = 8
	},
/obj/machinery/door/firedoor/border_only{
	dir = 4
	},
/obj/machinery/atmospherics/pipe/simple/supply/hidden/layer4{
	dir = 4
	},
/obj/machinery/atmospherics/pipe/simple/scrubbers/hidden/layer2{
	dir = 8
	},
/obj/structure/cable{
	icon_state = "4-8"
	},
/obj/structure/catwalk/over/plated_catwalk/dark,
/obj/machinery/door/airlock/maintenance_hatch{
	dir = 8
	},
/turf/open/floor/plating,
/area/space)
"Qc" = (
/obj/structure/cable{
	icon_state = "4-8"
	},
/obj/structure/catwalk/over/plated_catwalk,
/turf/open/floor/plating,
/area/space)
"QN" = (
/obj/structure/rack,
/obj/effect/turf_decal/siding/wideplating{
	dir = 4
	},
/turf/open/floor/plasteel/patterned,
/area/space)
"Rd" = (
/obj/effect/turf_decal/siding/wideplating{
	dir = 10
	},
/obj/structure/rack,
/turf/open/floor/plasteel/patterned,
/area/space)
"Rv" = (
/obj/structure/window/reinforced/fulltile/shuttle,
/obj/machinery/door/firedoor/border_only{
	dir = 8
	},
/obj/structure/grille,
/obj/machinery/door/firedoor/border_only{
	dir = 4
	},
/turf/open/floor/plating,
/area/space)
"RQ" = (
/obj/structure/window/reinforced/fulltile/shuttle,
/obj/machinery/door/firedoor/border_only,
/obj/machinery/door/firedoor/border_only{
	dir = 4
	},
/obj/structure/grille,
/turf/open/floor/plating,
/area/space)
"Sr" = (
/obj/structure/catwalk/over/plated_catwalk,
/obj/structure/cable{
	icon_state = "0-2"
	},
/obj/machinery/door/firedoor/border_only,
/obj/machinery/door/firedoor/border_only{
	dir = 1
	},
/turf/open/floor/plating,
/area/space)
"SB" = (
/obj/structure/grille,
/obj/structure/window/reinforced/fulltile/shuttle,
/obj/machinery/door/firedoor/border_only{
	dir = 4
	},
/obj/machinery/door/firedoor/border_only{
	dir = 1
	},
/turf/open/floor/plating,
/area/space)
"Tj" = (
/obj/structure/window/reinforced/fulltile/shuttle,
/obj/machinery/door/firedoor/border_only{
	dir = 1
	},
/obj/machinery/door/firedoor/border_only,
/obj/structure/grille,
/turf/open/floor/plating,
/area/space)
"TP" = (
/obj/structure/catwalk/over/plated_catwalk,
/obj/structure/cable{
	icon_state = "1-8"
	},
/turf/open/floor/plating,
/area/space)
"TT" = (
/turf/closed/wall/mineral/titanium,
/area/space)
"Uh" = (
/turf/open/floor/plasteel/mono,
/area/space)
"Ur" = (
/obj/structure/window/reinforced/fulltile/shuttle,
/obj/machinery/door/firedoor/border_only,
/obj/machinery/door/firedoor/border_only{
	dir = 8
	},
/obj/structure/grille,
/turf/open/floor/plating,
/area/space)
"VT" = (
/obj/structure/filingcabinet/chestdrawer/wheeled{
	dir = 8;
	pixel_y = 4;
	pixel_x = -2
	},
/obj/effect/turf_decal/siding/wideplating{
	dir = 8
	},
/turf/open/floor/plasteel/patterned/ridged,
/area/space)
"Wl" = (
/obj/structure/table,
/turf/open/floor/plasteel/mono,
/area/space)
"WF" = (
/obj/structure/catwalk/over/plated_catwalk,
/obj/structure/cable{
	icon_state = "1-2"
	},
/turf/open/floor/plating,
/area/space)
"WN" = (
/obj/structure/window/reinforced/fulltile/shuttle,
/obj/machinery/door/firedoor/border_only{
	dir = 4
	},
/obj/structure/grille,
/obj/machinery/door/firedoor/border_only{
	dir = 8
	},
/turf/open/floor/plating,
/area/space)
"Xg" = (
/obj/structure/catwalk/over/plated_catwalk/dark,
/obj/machinery/power/terminal,
/obj/structure/cable{
	icon_state = "0-4"
	},
/turf/open/floor/plating,
/area/space)
"Xo" = (
/obj/structure/cable{
	icon_state = "1-4"
	},
/obj/machinery/airalarm/directional/south,
/obj/structure/catwalk/over/plated_catwalk,
/turf/open/floor/plating,
/area/space)
"Xy" = (
/obj/machinery/power/shuttle/engine/electric{
	dir = 1
	},
/obj/structure/cable/cyan,
/turf/open/floor/plating,
/area/space)
"XZ" = (
/obj/structure/catwalk/over/plated_catwalk/dark,
/obj/machinery/power/terminal,
/obj/structure/cable,
/turf/open/floor/plating,
/area/space)
"Zv" = (
/obj/structure/window/reinforced/fulltile/shuttle,
/obj/machinery/door/firedoor/border_only{
	dir = 4
	},
/obj/machinery/door/firedoor/border_only,
/obj/structure/grille,
/turf/open/floor/plating,
/area/space)

(1,1,1) = {"
Kf
Kf
Kf
Kf
Kf
Kf
Kf
Kf
Kf
Kf
Kf
Kf
Kf
Kf
Kf
Kf
Kf
Kf
Kf
gv
gv
gv
gv
gv
gv
gv
gv
gv
gv
gv
gv
gv
gv
gv
gv
gv
gv
gv
gv
gv
gv
gv
gv
gv
gv
gv
gv
gv
gv
gv
gv
gv
"}
(2,1,1) = {"
Kf
Kf
Kf
Kf
Kf
Kf
Kf
Kf
Kf
Kf
Kf
Kf
Kf
Kf
Kf
Kf
Kf
Kf
Kf
gv
Kf
Kf
Kf
Kf
Kf
Kf
Kf
Kf
Kf
Kf
Kf
Kf
Kf
Kf
Kf
gv
Kf
Kf
Kf
Kf
Kf
Kf
Kf
Kf
Kf
Kf
Kf
Kf
Kf
Kf
Kf
gv
"}
(3,1,1) = {"
Kf
Kf
Kf
Kf
Kf
Kf
Kf
Kf
Kf
Kf
Kf
Kf
Kf
Kf
Kf
Kf
Kf
Kf
Kf
gv
Kf
Kf
Kf
Kf
Kf
Kf
Kf
Kf
Kf
Kf
Kf
Kf
Kf
Kf
Kf
gv
Kf
Kf
Kf
Kf
Kf
Kf
Kf
Kf
Kf
Kf
Kf
Kf
Kf
Kf
Kf
gv
"}
(4,1,1) = {"
Kf
Kf
Kf
Kf
Kf
Kf
Kf
Kf
Kf
Kf
Kf
Kf
Kf
Kf
Kf
Kf
Kf
Kf
Kf
gv
Kf
Kf
Kf
Kf
Kf
Kf
Kf
Kf
Kf
Kf
Kf
Kf
Kf
Kf
Kf
gv
Kf
Kf
Kf
Kf
Kf
Kf
Kf
Kf
Kf
Kf
Kf
Kf
Kf
Kf
Kf
gv
"}
(5,1,1) = {"
Kf
Kf
Kf
Kf
Kf
Kf
Kf
Kf
Kf
Kf
Kf
Kf
Kf
Kf
Kf
Kf
Kf
Kf
Kf
gv
Kf
Kf
Kf
Kf
Kf
Kf
Kf
Kf
Kf
Kf
Kf
Kf
Kf
Kf
Kf
gv
Kf
Kf
Kf
Kf
Kf
Kf
Kf
Kf
Kf
Kf
Kf
Kf
Kf
Kf
Kf
gv
"}
(6,1,1) = {"
Kf
Kf
Kf
Kf
Kf
Kf
Kf
Kf
Kf
Kf
Kf
Kf
Kf
Kf
Kf
Kf
Kf
Kf
Kf
gv
Kf
Kf
Kf
Kf
Kf
Kf
Kf
Kf
Kf
Kf
Kf
Kf
Kf
Kf
Kf
gv
Kf
Kf
Kf
Kf
Kf
Kf
Uh
Uh
Uh
Kf
Kf
Kf
Kf
Kf
Kf
gv
"}
(7,1,1) = {"
Kf
Kf
Kf
Kf
Kf
Kf
Kf
Kf
Kf
Kf
Kf
Kf
Kf
Kf
Kf
Kf
Kf
Kf
Kf
gv
Kf
Kf
Kf
Kf
Kf
Kf
Kf
Kf
Kf
Kf
Kf
Kf
Kf
Kf
Kf
gv
Kf
Kf
Kf
Kf
Kf
Uh
Wl
Wl
Wl
Uh
Kf
Kf
Kf
Kf
Kf
gv
"}
(8,1,1) = {"
Kf
Kf
Kf
Kf
Kf
Kf
Kf
Kf
Kf
Kf
Kf
Kf
Kf
Kf
Kf
Kf
Kf
Kf
Kf
gv
Kf
Kf
Kf
Kf
Kf
Kf
Kf
Kf
Kf
Kf
Kf
Kf
Kf
Kf
Kf
gv
Kf
Kf
Kf
Kf
Kf
Uh
Wl
Uh
Wl
Uh
Kf
Kf
Kf
Kf
Kf
gv
"}
(9,1,1) = {"
Kf
Kf
Kf
Kf
Kf
Kf
Kf
Kf
Kf
Kf
Kf
Kf
Kf
Kf
Kf
Kf
Kf
Kf
Kf
gv
Kf
Kf
Kf
Kf
Kf
Kf
Kf
Kf
Kf
Kf
Kf
Kf
Kf
Kf
Kf
gv
Kf
Kf
Kf
Kf
Kf
Uh
Wl
Wl
Wl
Uh
Kf
Kf
Kf
Kf
Kf
gv
"}
(10,1,1) = {"
Kf
Kf
Kf
Kf
Kf
Kf
Kf
Kf
Kf
Kf
Kf
Kf
Kf
Kf
Kf
Kf
Kf
Kf
Kf
gv
Kf
Kf
Kf
Kf
Kf
Kf
Kf
Kf
Kf
Kf
Kf
Kf
Kf
Kf
Kf
gv
Kf
Kf
Kf
Kf
Kf
Kf
Uh
Uh
Uh
Kf
Kf
Kf
Kf
Kf
Kf
gv
"}
(11,1,1) = {"
Kf
Kf
Kf
Kf
Kf
Kf
Kf
Kf
Kf
Kf
Kf
Kf
Kf
Kf
Kf
Kf
Kf
Kf
Kf
gv
Kf
Kf
Kf
Kf
Kf
Kf
Kf
Kf
Kf
Kf
Kf
Kf
Kf
Kf
Kf
gv
Kf
Kf
Kf
Kf
Kf
Kf
Kf
Kf
Kf
Kf
Kf
Kf
Kf
Kf
Kf
gv
"}
(12,1,1) = {"
Kf
Kf
Kf
Kf
Kf
Kf
Kf
Kf
Kf
Kf
Kf
Kf
Kf
Kf
Kf
Kf
Kf
Kf
Kf
gv
Kf
Kf
Kf
Kf
Kf
Kf
Kf
Kf
Kf
Kf
Kf
Kf
Kf
Kf
Kf
gv
Kf
Kf
Kf
Kf
Kf
Kf
Kf
Kf
Kf
Kf
Kf
Kf
Kf
Kf
Kf
gv
"}
(13,1,1) = {"
Kf
Kf
Kf
Kf
Kf
Kf
Kf
Kf
Kf
Kf
Kf
Kf
Kf
Kf
Kf
Kf
Kf
Kf
Kf
gv
Kf
Kf
Kf
Kf
Kf
Kf
Kf
Kf
Kf
Kf
Kf
Kf
Kf
Kf
Kf
gv
Kf
Kf
Kf
Kf
Kf
Kf
Kf
Kf
Kf
Kf
Kf
Kf
Kf
Kf
Kf
gv
"}
(14,1,1) = {"
Kf
Kf
Kf
Kf
Kf
Kf
Kf
Kf
Kf
Kf
Kf
Kf
Kf
Kf
Kf
Kf
Kf
Kf
Kf
gv
Kf
Kf
Kf
Kf
Kf
Kf
Kf
Kf
Kf
Kf
Kf
Kf
Kf
Kf
Kf
gv
Kf
Kf
Kf
Kf
Kf
Kf
Kf
Kf
Kf
Kf
Kf
Kf
Kf
Kf
Kf
gv
"}
(15,1,1) = {"
Kf
Kf
Kf
Kf
Kf
Kf
Kf
Kf
Kf
Kf
Kf
Kf
Kf
Kf
Kf
Kf
Kf
Kf
Kf
gv
Kf
Kf
Kf
Kf
Kf
Kf
Kf
Kf
Kf
Kf
Kf
Kf
Kf
Kf
Kf
gv
Kf
Kf
Kf
Kf
Kf
Kf
Kf
Kf
Kf
Kf
Kf
Kf
Kf
Kf
Kf
gv
"}
(16,1,1) = {"
Kf
Kf
Kf
Kf
Kf
Kf
Kf
Kf
Kf
Kf
Kf
Kf
Kf
Kf
Kf
Kf
Kf
Kf
Kf
gv
Kf
Kf
Kf
Kf
Kf
Kf
Kf
Kf
Kf
Kf
Kf
Kf
Kf
Kf
Kf
gv
Kf
Kf
Kf
Kf
Kf
Kf
Kf
Kf
Kf
Kf
Kf
Kf
Kf
Kf
Kf
gv
"}
(17,1,1) = {"
Kf
Kf
Kf
Kf
Kf
Kf
Kf
Kf
Kf
Kf
Kf
Kf
Kf
Kf
Kf
Kf
Kf
Kf
Kf
gv
gv
gv
gv
gv
gv
gv
gv
gv
gv
gv
gv
gv
gv
gv
gv
gv
gv
gv
gv
gv
gv
gv
gv
gv
gv
gv
gv
gv
gv
gv
gv
gv
"}
(18,1,1) = {"
Kf
Kf
Kf
Kf
Kf
Kf
Kf
Kf
Kf
Kf
Kf
Kf
Kf
Kf
Kf
Kf
Kf
Kf
Kf
gv
Kf
Kf
Kf
Kf
Kf
Kf
Kf
Kf
Kf
Kf
Kf
Kf
Kf
Kf
Kf
gv
Kf
Kf
Kf
Kf
Kf
TT
bz
TT
TT
TT
TT
Kf
Kf
Kf
Kf
gv
"}
(19,1,1) = {"
Kf
Kf
Kf
Kf
Kf
Kf
Kf
Kf
Kf
Kf
Kf
Kf
Kf
Kf
Kf
Kf
Kf
Kf
Kf
gv
Kf
Kf
Kf
Kf
Kf
Kf
Kf
Kf
Kf
Kf
Kf
Kf
Kf
Kf
Kf
gv
Kf
Kf
Kf
Kf
hd
RQ
LE
TT
Ff
Xg
Gr
Xy
Kf
Kf
Kf
gv
"}
(20,1,1) = {"
Kf
Kf
Kf
Kf
Kf
Kf
Kf
Kf
Kf
Kf
Kf
Kf
Kf
Kf
Kf
Kf
Kf
Kf
Kf
gv
Kf
Kf
Kf
Kf
Kf
Kf
Kf
Kf
Kf
Kf
Kf
Kf
Kf
Kf
Kf
gv
Kf
Kf
Kf
di
RQ
vY
uh
TT
pT
jY
TT
TT
Kf
Kf
Kf
gv
"}
(21,1,1) = {"
Kf
Kf
Kf
Kf
Kf
Kf
Kf
Kf
Kf
Kf
Kf
Kf
Kf
Kf
Kf
Kf
Kf
Kf
Kf
gv
Kf
Kf
Kf
Kf
Kf
Kf
Kf
Kf
Kf
Kf
Kf
Kf
Kf
Kf
Kf
gv
Kf
TT
WN
RQ
QN
sn
uh
TT
Cz
sZ
XZ
Gr
Xy
Kf
Kf
gv
"}
(22,1,1) = {"
Kf
Kf
Kf
Kf
Kf
Kf
Kf
Kf
Kf
Kf
Kf
Kf
Kf
Kf
Kf
Kf
Kf
Kf
Kf
gv
Kf
Kf
Kf
Kf
Kf
Kf
Kf
Kf
Kf
Kf
Kf
Kf
Kf
Kf
Kf
gv
nQ
TT
Fs
WF
WF
WF
Xo
TT
TT
wq
TT
TT
TT
TT
Kf
gv
"}
(23,1,1) = {"
Kf
Kf
Kf
Kf
Kf
Kf
Kf
Kf
Kf
Kf
Kf
Kf
Kf
Kf
Kf
Kf
Kf
Kf
Kf
gv
Kf
Kf
Kf
Kf
Kf
Kf
Kf
Kf
Kf
Kf
Kf
Kf
Kf
Kf
Kf
gv
Oa
Sr
TP
ob
vC
Lt
cO
ao
jj
Qc
ae
ae
Dw
IR
Lo
gv
"}
(24,1,1) = {"
Kf
Kf
Kf
Kf
Kf
Kf
Kf
Kf
Kf
Kf
Kf
Kf
Kf
Kf
Kf
Kf
Kf
Kf
Kf
gv
Kf
Kf
Kf
Kf
Kf
Kf
Kf
Kf
Kf
Kf
Kf
Kf
Kf
Kf
Kf
gv
Oa
Lm
bH
fr
Uh
uh
cO
DW
DB
Qc
oq
do
Fs
EB
Tj
gv
"}
(25,1,1) = {"
Kf
Kf
Kf
Kf
Kf
Kf
Kf
Kf
Kf
Kf
Kf
Kf
Kf
Kf
Kf
Kf
Kf
Kf
Kf
gv
Kf
Kf
Kf
Kf
Kf
Kf
Kf
Kf
Kf
Kf
Kf
Kf
Kf
Kf
Kf
gv
Oa
Lm
bH
ob
vC
Lt
cO
yQ
av
Qc
CO
sR
cO
HE
Tj
gv
"}
(26,1,1) = {"
Kf
Kf
Kf
Kf
Kf
Kf
Kf
Kf
Kf
Kf
Kf
Kf
Kf
Kf
Kf
Kf
Kf
Kf
Kf
gv
Kf
Kf
Kf
Kf
Kf
Kf
Kf
Kf
Kf
Kf
Kf
Kf
Kf
Kf
Kf
gv
Oa
Lm
bH
fr
Uh
uh
cO
TT
pW
mB
WF
WF
TP
th
Tj
gv
"}
(27,1,1) = {"
Kf
Kf
Kf
Kf
Kf
Kf
Kf
Kf
Kf
Kf
Kf
Kf
Kf
Kf
Kf
Kf
Kf
Kf
Kf
gv
Kf
Kf
Kf
Kf
Kf
Kf
Kf
Kf
Kf
Kf
Kf
Kf
Kf
Kf
Kf
gv
Oa
Sr
dx
ob
vC
Lt
gc
oR
Or
wc
qg
VT
jc
hd
Zv
gv
"}
(28,1,1) = {"
Kf
Kf
Kf
Kf
Kf
Kf
Kf
Kf
Kf
Kf
Kf
Kf
Kf
Kf
Kf
Kf
Kf
Kf
Kf
gv
Kf
Kf
Kf
Kf
Kf
Kf
Kf
Kf
Kf
Kf
Kf
Kf
Kf
Kf
Kf
gv
oL
TT
gu
WF
WF
PM
Ba
TT
TT
PY
TT
TT
TT
TT
Kf
gv
"}
(29,1,1) = {"
Kf
Kf
Kf
Kf
Kf
Kf
Kf
Kf
Kf
Kf
Kf
Kf
Kf
Kf
Kf
Kf
Kf
Kf
Kf
gv
Kf
Kf
Kf
Kf
Kf
Kf
Kf
Kf
Kf
Kf
Kf
Kf
Kf
Kf
Kf
gv
Kf
TT
Rv
Ur
sj
Rd
cP
TT
IK
am
XZ
pn
Xy
Kf
Kf
gv
"}
(30,1,1) = {"
Kf
Kf
Kf
Kf
Kf
Kf
Kf
Kf
Kf
Kf
Kf
Kf
Kf
Kf
Kf
Kf
Kf
Kf
Kf
gv
Kf
Kf
Kf
Kf
Kf
Kf
Kf
Kf
Kf
Kf
Kf
Kf
Kf
Kf
Kf
gv
Kf
Kf
Kf
SB
Lo
DS
sG
TT
go
JT
TT
TT
Kf
Kf
Kf
gv
"}
(31,1,1) = {"
Kf
Kf
Kf
Kf
Kf
Kf
Kf
Kf
Kf
Kf
Kf
Kf
Kf
Kf
Kf
Kf
Kf
Kf
Kf
gv
Kf
Kf
Kf
Kf
Kf
Kf
Kf
Kf
Kf
Kf
Kf
Kf
Kf
Kf
Kf
gv
Kf
Kf
Kf
Kf
OA
Lo
uz
TT
uT
Jl
pn
Xy
Kf
Kf
Kf
gv
"}
(32,1,1) = {"
Kf
Kf
Kf
Kf
Kf
Kf
Kf
Kf
Kf
Kf
Kf
Kf
Kf
Kf
Kf
Kf
Kf
Kf
Kf
gv
Kf
Kf
Kf
Kf
Kf
Kf
Kf
Kf
Kf
Kf
Kf
Kf
Kf
Kf
Kf
gv
Kf
Kf
Kf
Kf
Kf
DV
ft
TT
TT
TT
TT
Kf
Kf
Kf
Kf
gv
"}
(33,1,1) = {"
Kf
Kf
Kf
Kf
Kf
Kf
Kf
Kf
Kf
Kf
Kf
Kf
Kf
Kf
Kf
Kf
Kf
Kf
Kf
gv
gv
gv
gv
gv
gv
gv
gv
gv
gv
gv
gv
gv
gv
gv
gv
gv
gv
gv
gv
gv
gv
gv
gv
gv
gv
gv
gv
gv
gv
gv
gv
gv
"}
(34,1,1) = {"
Kf
Kf
Kf
Kf
Kf
Kf
Kf
Kf
Kf
Kf
Kf
Kf
Kf
Kf
Kf
Kf
Kf
Kf
Kf
gv
Kf
Kf
Kf
Kf
Kf
Kf
Kf
Kf
Kf
Kf
Kf
Kf
Kf
Kf
Kf
gv
Kf
Kf
Kf
Kf
Kf
Kf
Kf
Kf
Kf
Kf
Kf
Kf
Kf
Kf
Kf
gv
"}
(35,1,1) = {"
Kf
Kf
Kf
Kf
Kf
Kf
Kf
Kf
Kf
Kf
Kf
Kf
Kf
Kf
Kf
Kf
Kf
Kf
Kf
gv
Kf
Kf
Kf
Kf
Kf
Kf
Kf
Kf
Kf
Kf
Kf
Kf
Kf
Kf
Kf
gv
Kf
Kf
Kf
Kf
Kf
Kf
Kf
Kf
Kf
Kf
Kf
Kf
Kf
Kf
Kf
gv
"}
(36,1,1) = {"
Kf
Kf
Kf
Kf
Kf
Kf
Kf
Kf
Kf
Kf
Kf
Kf
Kf
Kf
Kf
Kf
Kf
Kf
Kf
gv
Kf
Kf
Kf
Kf
Kf
Kf
Kf
Kf
Kf
Kf
Kf
Kf
Kf
Kf
Kf
gv
Kf
Kf
Kf
Kf
Kf
Kf
Kf
Kf
Kf
Kf
Kf
Kf
Kf
Kf
Kf
gv
"}
(37,1,1) = {"
Kf
Kf
Kf
Kf
Kf
Kf
Kf
Kf
Kf
Kf
Kf
Kf
Kf
Kf
Kf
Kf
Kf
Kf
Kf
gv
Kf
Kf
Kf
Kf
Kf
Kf
Kf
Kf
Kf
Kf
Kf
Kf
Kf
Kf
Kf
gv
Kf
Kf
Kf
Kf
Kf
Kf
Kf
Kf
Kf
Kf
Kf
Kf
Kf
Kf
Kf
gv
"}
(38,1,1) = {"
Kf
Kf
Kf
Kf
Kf
Kf
Kf
Kf
Kf
Kf
Kf
Kf
Kf
Kf
Kf
Kf
Kf
Kf
Kf
gv
Kf
Kf
Kf
Kf
Kf
Kf
Kf
Kf
Kf
Kf
Kf
Kf
Kf
Kf
Kf
gv
Kf
Kf
Kf
Kf
Kf
Kf
Kf
Kf
Kf
Kf
Kf
Kf
Kf
Kf
Kf
gv
"}
(39,1,1) = {"
Kf
Kf
Kf
Kf
Kf
Kf
Kf
Kf
Kf
Kf
Kf
Kf
Kf
Kf
Kf
Kf
Kf
Kf
Kf
gv
Kf
Kf
Kf
Kf
Kf
Kf
Kf
Kf
Kf
Kf
Kf
Kf
Kf
Kf
Kf
gv
Kf
Kf
Kf
Kf
Kf
Kf
Kf
Kf
Kf
Kf
Kf
Kf
Kf
Kf
Kf
gv
"}
(40,1,1) = {"
Kf
Kf
Kf
Kf
Kf
Kf
Kf
Kf
Kf
Kf
Kf
Kf
Kf
Kf
Kf
Kf
Kf
Kf
Kf
gv
Kf
Kf
Kf
Kf
Kf
Kf
Kf
Kf
Kf
Kf
Kf
Kf
Kf
Kf
Kf
gv
Kf
Kf
Kf
Kf
Kf
Kf
Kf
Kf
Kf
Kf
Kf
Kf
Kf
Kf
Kf
gv
"}
(41,1,1) = {"
Kf
Kf
Kf
Kf
Kf
Kf
Kf
Kf
Kf
Kf
Kf
Kf
Kf
Kf
Kf
Kf
Kf
Kf
Kf
gv
Kf
Kf
Kf
Kf
Kf
Kf
Kf
Kf
Kf
Kf
Kf
Kf
Kf
Kf
Kf
gv
Kf
Kf
Kf
Kf
Kf
Kf
Kf
Kf
Kf
Kf
Kf
Kf
Kf
Kf
Kf
gv
"}
(42,1,1) = {"
Kf
Kf
Kf
Kf
Kf
Kf
Kf
Kf
Kf
Kf
Kf
Kf
Kf
Kf
Kf
Kf
Kf
Kf
Kf
gv
Kf
Kf
Kf
Kf
Kf
Kf
Kf
Kf
Kf
Kf
Kf
Kf
Kf
Kf
Kf
gv
Kf
Kf
Kf
Kf
Kf
Kf
Kf
Kf
Kf
Kf
Kf
Kf
Kf
Kf
Kf
gv
"}
(43,1,1) = {"
Kf
Kf
Kf
Kf
Kf
Kf
Kf
Kf
Kf
Kf
Kf
Kf
Kf
Kf
Kf
Kf
Kf
Kf
Kf
gv
Kf
Kf
Kf
Kf
Kf
Kf
Kf
Kf
Kf
Kf
Kf
Kf
Kf
Kf
Kf
gv
Kf
Kf
Kf
Kf
Kf
Kf
Kf
Kf
Kf
Kf
Kf
Kf
Kf
Kf
Kf
gv
"}
(44,1,1) = {"
Kf
Kf
Kf
Kf
Kf
Kf
Kf
Kf
Kf
Kf
Kf
Kf
Kf
Kf
Kf
Kf
Kf
Kf
Kf
gv
Kf
Kf
Kf
Kf
Kf
Kf
Kf
Kf
Kf
Kf
Kf
Kf
Kf
Kf
Kf
gv
Kf
Kf
Kf
Kf
Kf
Kf
Kf
Kf
Kf
Kf
Kf
Kf
Kf
Kf
Kf
gv
"}
(45,1,1) = {"
Kf
Kf
Kf
Kf
Kf
Kf
Kf
Kf
Kf
Kf
Kf
Kf
Kf
Kf
Kf
Kf
Kf
Kf
Kf
gv
Kf
Kf
Kf
Kf
Kf
Kf
Kf
Kf
Kf
Kf
Kf
Kf
Kf
Kf
Kf
gv
Kf
Kf
Kf
Kf
Kf
Kf
Kf
Kf
Kf
Kf
Kf
Kf
Kf
Kf
Kf
gv
"}
(46,1,1) = {"
Kf
Kf
Kf
Kf
Kf
Kf
Kf
Kf
Kf
Kf
Kf
Kf
Kf
Kf
Kf
Kf
Kf
Kf
Kf
gv
Kf
Kf
Kf
Kf
Kf
Kf
Kf
Kf
Kf
Kf
Kf
Kf
Kf
Kf
Kf
gv
Kf
Kf
Kf
Kf
Kf
Kf
Kf
Kf
Kf
Kf
Kf
Kf
Kf
Kf
Kf
gv
"}
(47,1,1) = {"
Kf
Kf
Kf
Kf
Kf
Kf
Kf
Kf
Kf
Kf
Kf
Kf
Kf
Kf
Kf
Kf
Kf
Kf
Kf
gv
Kf
Kf
Kf
Kf
Kf
Kf
Kf
Kf
Kf
Kf
Kf
Kf
Kf
Kf
Kf
gv
Kf
Kf
Kf
Kf
Kf
Kf
Kf
Kf
Kf
Kf
Kf
Kf
Kf
Kf
Kf
gv
"}
(48,1,1) = {"
Kf
Kf
Kf
Kf
Kf
Kf
Kf
Kf
Kf
Kf
Kf
Kf
Kf
Kf
Kf
Kf
Kf
Kf
Kf
gv
Kf
Kf
Kf
Kf
Kf
Kf
Kf
Kf
Kf
Kf
Kf
Kf
Kf
Kf
Kf
gv
Kf
Kf
Kf
Kf
Kf
Kf
Kf
Kf
Kf
Kf
Kf
Kf
Kf
Kf
Kf
gv
"}
(49,1,1) = {"
Kf
Kf
Kf
Kf
Kf
Kf
Kf
Kf
Kf
Kf
Kf
Kf
Kf
Kf
Kf
Kf
Kf
Kf
Kf
gv
gv
gv
gv
gv
gv
gv
gv
gv
gv
gv
gv
gv
gv
gv
gv
gv
gv
gv
gv
gv
gv
gv
gv
gv
gv
gv
gv
gv
gv
gv
gv
gv
"}
(50,1,1) = {"
Kf
Kf
Kf
Kf
Kf
Kf
Kf
Kf
Kf
Kf
Kf
Kf
Kf
Kf
Kf
Kf
Kf
Kf
Kf
Kf
Kf
Kf
Kf
Kf
Kf
Kf
Kf
Kf
Kf
Kf
Kf
Kf
Kf
Kf
Kf
Kf
Kf
Kf
Kf
Kf
Kf
Kf
Kf
Kf
Kf
Kf
Kf
Kf
Kf
Kf
Kf
Kf
"}
(51,1,1) = {"
Kf
Kf
Kf
Kf
Kf
Kf
Kf
Kf
Kf
Kf
Kf
Kf
Kf
Kf
Kf
Kf
Kf
Kf
Kf
Kf
Kf
Kf
Kf
Kf
Kf
Kf
Kf
Kf
Kf
Kf
Kf
Kf
Kf
Kf
Kf
Kf
Kf
Kf
Kf
Kf
Kf
Kf
Kf
Kf
Kf
Kf
Kf
Kf
Kf
Kf
Kf
Kf
"}
(52,1,1) = {"
Kf
Kf
Kf
Kf
Kf
Kf
Kf
Kf
Kf
Kf
Kf
Kf
Kf
Kf
Kf
Kf
Kf
Kf
Kf
Kf
Kf
Kf
Kf
Kf
Kf
Kf
Kf
Kf
Kf
Kf
Kf
Kf
Kf
Kf
Kf
Kf
Kf
Kf
Kf
Kf
Kf
Kf
Kf
Kf
Kf
Kf
Kf
Kf
Kf
Kf
Kf
Kf
"}
