//MAP CONVERTED BY dmm2tgm.py THIS HEADER COMMENT PREVENTS RECONVERSION, DO NOT REMOVE
"a" = (
/turf/closed/wall/mineral/plastitanium/nodiagonal,
/area/space)
"b" = (
/obj/structure/rack,
/turf/open/floor/plasteel/patterned,
/area/space)
"c" = (
/obj/machinery/power/shuttle/engine/electric{
	dir = 1
	},
/turf/open/floor/plating,
/area/space)
"d" = (
/turf/open/space/basic,
/area/space)
"g" = (
/turf/open/floor/plasteel,
/area/space)
"j" = (
/obj/structure/table,
/turf/open/floor/plasteel/tech,
/area/space)
"m" = (
/obj/machinery/power/port_gen/pacman/super,
/obj/structure/catwalk/over/plated_catwalk,
/turf/open/floor/plating,
/area/space)
"n" = (
/obj/structure/filingcabinet/chestdrawer/wheeled{
	dir = 8;
	pixel_y = 4;
	pixel_x = -2
	},
/turf/open/floor/plasteel/patterned,
/area/space)
"o" = (
/turf/closed/wall/mineral/titanium,
/area/space)
"p" = (
/obj/machinery/computer/bank_machine{
	dir = 8
	},
/turf/open/floor/plasteel/patterned,
/area/space)
"q" = (
/obj/machinery/vending/snack/random,
/turf/open/floor/plasteel/patterned,
/area/space)
"r" = (
/obj/structure/table,
/obj/item/paper_bin{
	pixel_y = 4;
	pixel_x = -5
	},
/obj/item/pen/fourcolor{
	pixel_y = 6;
	pixel_x = -5
	},
/obj/item/folder/red{
	pixel_x = 9;
	pixel_y = 2
	},
/obj/item/folder/blue{
	pixel_x = 8
	},
/turf/open/floor/plasteel,
/area/space)
"s" = (
/obj/structure/safe,
/obj/item/spacecash/bundle/loadsamoney,
/obj/item/spacecash/bundle/loadsamoney,
/obj/item/storage/bag/money,
/obj/item/card/bank,
/turf/open/floor/plasteel/patterned,
/area/space)
"u" = (
/obj/machinery/suit_storage_unit/inherit,
/obj/item/clothing/suit/space/hardsuit/carp,
/obj/item/clothing/mask/gas/carp,
/obj/item/tank/internals/emergency_oxygen/double,
/turf/open/floor/plasteel/patterned,
/area/space)
"w" = (
/turf/open/floor/plasteel/tech,
/area/space)
"x" = (
/turf/open/floor/engine/hull,
/area/space)
"y" = (
/obj/machinery/vending/cigarette,
/turf/open/floor/plasteel/patterned,
/area/space)
"A" = (
/obj/structure/window/reinforced/fulltile/shuttle,
/turf/open/floor/plating,
/area/space)
"B" = (
/turf/open/floor/plasteel/mono,
/area/space)
"C" = (
/obj/structure/table,
/obj/item/scanner_wand{
	pixel_x = -3;
	pixel_y = 4
	},
/obj/item/price_tagger{
	pixel_x = 9;
	pixel_y = 0
	},
/obj/item/table_bell{
	pixel_y = 10;
	pixel_x = -10
	},
/turf/open/floor/plasteel,
/area/space)
"E" = (
/obj/machinery/computer/helm{
	dir = 8
	},
/turf/open/floor/plasteel,
/area/space)
"F" = (
/obj/machinery/computer/cargo/express{
	dir = 4
	},
/turf/open/floor/plasteel,
/area/space)
"G" = (
/turf/open/floor/plasteel/patterned/ridged,
/area/space)
"J" = (
/obj/machinery/power/smes/shuttle/precharged{
	dir = 1
	},
/turf/open/floor/plating,
/area/space)
"L" = (
/obj/structure/catwalk/over/plated_catwalk,
/turf/open/floor/plating,
/area/space)
"M" = (
/obj/machinery/vending/coffee,
/turf/open/floor/plasteel/patterned,
/area/space)
"O" = (
/turf/open/floor/plating,
/area/space)
"Q" = (
/obj/structure/table,
/obj/machinery/paystand{
	pixel_y = 7;
	pixel_x = 1
	},
/turf/open/floor/plasteel,
/area/space)
"R" = (
/obj/structure/chair/comfy/shuttle{
	dir = 1
	},
/turf/open/floor/plasteel,
/area/space)
"T" = (
/obj/machinery/turretid{
	pixel_y = 24
	},
/turf/open/floor/plasteel,
/area/space)
"U" = (
/obj/machinery/vending/modularpc,
/turf/open/floor/plasteel/patterned,
/area/space)
"W" = (
/obj/machinery/power/smes/engineering,
/obj/structure/catwalk/over/plated_catwalk,
/turf/open/floor/plating,
/area/space)
"X" = (
/obj/structure/catwalk/over/plated_catwalk/dark,
/turf/open/floor/plating,
/area/space)
"Y" = (
/obj/structure/closet/crate,
/turf/open/floor/plasteel/patterned,
/area/space)

(1,1,1) = {"
d
d
d
d
d
d
d
d
d
d
d
d
d
d
d
d
d
d
d
a
a
a
a
a
a
a
a
a
a
a
a
a
a
a
a
a
a
a
a
a
a
a
a
a
a
a
a
a
a
a
a
a
"}
(2,1,1) = {"
d
d
d
d
d
d
d
d
d
d
d
d
d
d
d
d
d
d
d
a
d
d
d
d
d
d
d
d
d
d
d
d
d
d
d
a
d
d
d
O
O
a
a
a
d
d
d
d
d
d
d
a
"}
(3,1,1) = {"
d
d
d
d
d
d
d
d
d
d
d
d
d
d
d
d
d
d
d
a
d
d
d
d
d
d
d
d
d
d
d
d
d
d
d
a
d
d
O
O
w
w
w
a
a
a
a
d
d
d
d
a
"}
(4,1,1) = {"
d
d
d
d
d
d
d
d
d
d
d
d
d
d
d
d
d
d
d
a
d
d
d
d
d
d
d
d
d
d
d
d
d
d
d
a
d
d
O
w
w
w
w
w
w
w
w
d
d
d
d
a
"}
(5,1,1) = {"
d
d
d
d
d
d
d
d
d
d
d
d
d
d
d
d
d
d
d
a
d
d
d
d
d
d
d
d
d
d
d
d
d
d
d
a
d
d
O
O
w
w
w
w
w
a
a
a
d
d
d
a
"}
(6,1,1) = {"
d
d
d
d
d
d
d
d
d
d
d
d
d
d
d
d
d
d
d
a
d
d
d
d
d
d
d
d
d
d
d
d
d
d
d
a
d
d
d
O
O
a
w
w
w
w
w
a
a
a
d
a
"}
(7,1,1) = {"
d
d
d
d
d
d
d
d
d
d
d
d
d
d
d
d
d
d
d
a
d
d
d
d
d
d
d
d
d
d
d
d
d
d
d
a
d
d
d
d
d
w
w
j
j
w
w
w
w
a
a
a
"}
(8,1,1) = {"
d
d
d
d
d
d
d
d
d
d
d
d
d
d
d
d
d
d
d
a
d
d
d
d
d
d
d
d
d
d
d
d
d
d
d
a
d
d
d
d
d
w
w
j
w
w
w
w
w
w
a
a
"}
(9,1,1) = {"
d
d
d
d
d
d
d
d
d
d
d
d
d
d
d
d
d
d
d
a
d
d
d
d
d
d
d
d
d
d
d
d
d
d
d
a
d
d
d
d
d
w
w
j
w
w
w
w
w
w
a
a
"}
(10,1,1) = {"
d
d
d
d
d
d
d
d
d
d
d
d
d
d
d
d
d
d
d
a
d
d
d
d
d
d
d
d
d
d
d
d
d
d
d
a
d
d
d
d
d
w
w
j
w
w
w
w
w
w
a
a
"}
(11,1,1) = {"
d
d
d
d
d
d
d
d
d
d
d
d
d
d
d
d
d
d
d
a
d
d
d
d
d
d
d
d
d
d
d
d
d
d
d
a
d
d
d
d
d
w
w
j
j
w
w
w
w
a
a
a
"}
(12,1,1) = {"
d
d
d
d
d
d
d
d
d
d
d
d
d
d
d
d
d
d
d
a
d
d
d
d
d
d
d
d
d
d
d
d
d
d
d
a
d
d
d
O
O
a
w
w
w
w
w
a
a
a
d
a
"}
(13,1,1) = {"
d
d
d
d
d
d
d
d
d
d
d
d
d
d
d
d
d
d
d
a
d
d
d
d
d
d
d
d
d
d
d
d
d
d
d
a
d
d
O
O
w
w
w
w
w
a
a
a
d
d
d
a
"}
(14,1,1) = {"
d
d
d
d
d
d
d
d
d
d
d
d
d
d
d
d
d
d
d
a
d
d
d
d
d
d
d
d
d
d
d
d
d
d
d
a
d
d
O
w
w
w
w
w
w
w
w
d
d
d
d
a
"}
(15,1,1) = {"
d
d
d
d
d
d
d
d
d
d
d
d
d
d
d
d
d
d
d
a
d
d
d
d
d
d
d
d
d
d
d
d
d
d
d
a
d
d
O
O
w
w
w
a
a
a
a
d
d
d
d
a
"}
(16,1,1) = {"
d
d
d
d
d
d
d
d
d
d
d
d
d
d
d
d
d
d
d
a
d
d
d
d
d
d
d
d
d
d
d
d
d
d
d
a
d
d
d
O
O
a
a
a
d
d
d
d
d
d
d
a
"}
(17,1,1) = {"
d
d
d
d
d
d
d
d
d
d
d
d
d
d
d
d
d
d
d
a
a
a
a
a
a
a
a
a
a
a
a
a
a
a
a
a
a
a
a
a
a
a
a
a
a
a
a
a
a
a
a
a
"}
(18,1,1) = {"
d
d
d
d
d
d
d
d
d
d
d
d
d
d
d
d
d
d
d
a
d
d
d
d
d
d
d
d
d
d
d
d
d
d
d
a
d
d
d
d
d
d
d
o
o
o
o
d
d
d
d
a
"}
(19,1,1) = {"
d
d
d
d
d
d
d
d
d
d
d
d
d
d
d
d
d
d
d
a
d
d
d
d
d
d
d
d
d
d
d
d
d
d
d
a
d
d
d
d
A
A
A
o
w
X
J
c
d
d
d
a
"}
(20,1,1) = {"
d
d
d
d
d
d
d
d
d
d
d
d
d
d
d
d
d
d
d
a
d
d
d
d
d
d
d
d
d
d
d
d
d
d
d
a
d
d
A
A
A
y
U
o
w
X
o
o
d
d
d
a
"}
(21,1,1) = {"
d
d
d
d
d
d
d
d
d
d
d
d
d
d
d
d
d
d
d
a
d
d
d
d
d
d
d
d
d
d
d
d
d
d
d
a
d
o
A
b
b
B
L
X
X
X
X
J
c
d
d
a
"}
(22,1,1) = {"
d
d
d
d
d
d
d
d
d
d
d
d
d
d
d
d
d
d
d
a
d
d
d
d
d
d
d
d
d
d
d
d
d
d
d
a
x
o
L
L
L
L
L
o
o
o
o
o
o
o
d
a
"}
(23,1,1) = {"
d
d
d
d
d
d
d
d
d
d
d
d
d
d
d
d
d
d
d
a
d
d
d
d
d
d
d
d
d
d
d
d
d
d
d
a
x
L
L
b
b
b
L
r
F
g
b
b
u
A
A
a
"}
(24,1,1) = {"
d
d
d
d
d
d
d
d
d
d
d
d
d
d
d
d
d
d
d
a
d
d
d
d
d
d
d
d
d
d
d
d
d
d
d
a
x
G
B
B
B
B
L
C
R
g
g
g
g
W
A
a
"}
(25,1,1) = {"
d
d
d
d
d
d
d
d
d
d
d
d
d
d
d
d
d
d
d
a
d
d
d
d
d
d
d
d
d
d
d
d
d
d
d
a
x
G
B
b
b
b
L
Q
E
g
Y
Y
L
L
A
a
"}
(26,1,1) = {"
d
d
d
d
d
d
d
d
d
d
d
d
d
d
d
d
d
d
d
a
d
d
d
d
d
d
d
d
d
d
d
d
d
d
d
a
x
G
B
B
B
B
L
o
T
L
L
L
L
m
A
a
"}
(27,1,1) = {"
d
d
d
d
d
d
d
d
d
d
d
d
d
d
d
d
d
d
d
a
d
d
d
d
d
d
d
d
d
d
d
d
d
d
d
a
x
L
L
b
b
b
L
L
L
L
p
n
s
A
A
a
"}
(28,1,1) = {"
d
d
d
d
d
d
d
d
d
d
d
d
d
d
d
d
d
d
d
a
d
d
d
d
d
d
d
d
d
d
d
d
d
d
d
a
x
o
L
L
L
L
L
o
o
o
o
o
o
o
d
a
"}
(29,1,1) = {"
d
d
d
d
d
d
d
d
d
d
d
d
d
d
d
d
d
d
d
a
d
d
d
d
d
d
d
d
d
d
d
d
d
d
d
a
d
o
A
b
b
B
L
X
X
X
X
J
c
d
d
a
"}
(30,1,1) = {"
d
d
d
d
d
d
d
d
d
d
d
d
d
d
d
d
d
d
d
a
d
d
d
d
d
d
d
d
d
d
d
d
d
d
d
a
d
d
A
A
A
M
q
o
w
X
o
o
d
d
d
a
"}
(31,1,1) = {"
d
d
d
d
d
d
d
d
d
d
d
d
d
d
d
d
d
d
d
a
d
d
d
d
d
d
d
d
d
d
d
d
d
d
d
a
d
d
d
d
A
A
A
o
w
X
J
c
d
d
d
a
"}
(32,1,1) = {"
d
d
d
d
d
d
d
d
d
d
d
d
d
d
d
d
d
d
d
a
d
d
d
d
d
d
d
d
d
d
d
d
d
d
d
a
d
d
d
d
d
d
d
o
o
o
o
d
d
d
d
a
"}
(33,1,1) = {"
d
d
d
d
d
d
d
d
d
d
d
d
d
d
d
d
d
d
d
a
a
a
a
a
a
a
a
a
a
a
a
a
a
a
a
a
a
a
a
a
a
a
a
a
a
a
a
a
a
a
a
a
"}
(34,1,1) = {"
d
d
d
d
d
d
d
d
d
d
d
d
d
d
d
d
d
d
d
a
d
d
d
d
d
d
d
d
d
d
d
d
d
d
d
a
d
d
d
d
d
d
d
d
d
d
d
d
d
d
d
a
"}
(35,1,1) = {"
d
d
d
d
d
d
d
d
d
d
d
d
d
d
d
d
d
d
d
a
d
d
d
d
d
d
d
d
d
d
d
d
d
d
d
a
d
d
d
d
d
d
d
d
d
d
d
d
d
d
d
a
"}
(36,1,1) = {"
d
d
d
d
d
d
d
d
d
d
d
d
d
d
d
d
d
d
d
a
d
d
d
d
d
d
d
d
d
d
d
d
d
d
d
a
d
d
d
d
d
d
d
d
d
d
d
d
d
d
d
a
"}
(37,1,1) = {"
d
d
d
d
d
d
d
d
d
d
d
d
d
d
d
d
d
d
d
a
d
d
d
d
d
d
d
d
d
d
d
d
d
d
d
a
d
d
d
d
d
d
d
d
d
d
d
d
d
d
d
a
"}
(38,1,1) = {"
d
d
d
d
d
d
d
d
d
d
d
d
d
d
d
d
d
d
d
a
d
d
d
d
d
d
d
d
d
d
d
d
d
d
d
a
d
d
d
d
d
d
d
d
d
d
d
d
d
d
d
a
"}
(39,1,1) = {"
d
d
d
d
d
d
d
d
d
d
d
d
d
d
d
d
d
d
d
a
d
d
d
d
d
d
d
d
d
d
d
d
d
d
d
a
d
d
d
d
d
d
d
d
d
d
d
d
d
d
d
a
"}
(40,1,1) = {"
d
d
d
d
d
d
d
d
d
d
d
d
d
d
d
d
d
d
d
a
d
d
d
d
d
d
d
d
d
d
d
d
d
d
d
a
d
d
d
d
d
d
d
d
d
d
d
d
d
d
d
a
"}
(41,1,1) = {"
d
d
d
d
d
d
d
d
d
d
d
d
d
d
d
d
d
d
d
a
d
d
d
d
d
d
d
d
d
d
d
d
d
d
d
a
d
d
d
d
d
d
d
d
d
d
d
d
d
d
d
a
"}
(42,1,1) = {"
d
d
d
d
d
d
d
d
d
d
d
d
d
d
d
d
d
d
d
a
d
d
d
d
d
d
d
d
d
d
d
d
d
d
d
a
d
d
d
d
d
d
d
d
d
d
d
d
d
d
d
a
"}
(43,1,1) = {"
d
d
d
d
d
d
d
d
d
d
d
d
d
d
d
d
d
d
d
a
d
d
d
d
d
d
d
d
d
d
d
d
d
d
d
a
d
d
d
d
d
d
d
d
d
d
d
d
d
d
d
a
"}
(44,1,1) = {"
d
d
d
d
d
d
d
d
d
d
d
d
d
d
d
d
d
d
d
a
d
d
d
d
d
d
d
d
d
d
d
d
d
d
d
a
d
d
d
d
d
d
d
d
d
d
d
d
d
d
d
a
"}
(45,1,1) = {"
d
d
d
d
d
d
d
d
d
d
d
d
d
d
d
d
d
d
d
a
d
d
d
d
d
d
d
d
d
d
d
d
d
d
d
a
d
d
d
d
d
d
d
d
d
d
d
d
d
d
d
a
"}
(46,1,1) = {"
d
d
d
d
d
d
d
d
d
d
d
d
d
d
d
d
d
d
d
a
d
d
d
d
d
d
d
d
d
d
d
d
d
d
d
a
d
d
d
d
d
d
d
d
d
d
d
d
d
d
d
a
"}
(47,1,1) = {"
d
d
d
d
d
d
d
d
d
d
d
d
d
d
d
d
d
d
d
a
d
d
d
d
d
d
d
d
d
d
d
d
d
d
d
a
d
d
d
d
d
d
d
d
d
d
d
d
d
d
d
a
"}
(48,1,1) = {"
d
d
d
d
d
d
d
d
d
d
d
d
d
d
d
d
d
d
d
a
d
d
d
d
d
d
d
d
d
d
d
d
d
d
d
a
d
d
d
d
d
d
d
d
d
d
d
d
d
d
d
a
"}
(49,1,1) = {"
d
d
d
d
d
d
d
d
d
d
d
d
d
d
d
d
d
d
d
a
a
a
a
a
a
a
a
a
a
a
a
a
a
a
a
a
a
a
a
a
a
a
a
a
a
a
a
a
a
a
a
a
"}
(50,1,1) = {"
d
d
d
d
d
d
d
d
d
d
d
d
d
d
d
d
d
d
d
d
d
d
d
d
d
d
d
d
d
d
d
d
d
d
d
d
d
d
d
d
d
d
d
d
d
d
d
d
d
d
d
d
"}
(51,1,1) = {"
d
d
d
d
d
d
d
d
d
d
d
d
d
d
d
d
d
d
d
d
d
d
d
d
d
d
d
d
d
d
d
d
d
d
d
d
d
d
d
d
d
d
d
d
d
d
d
d
d
d
d
d
"}
(52,1,1) = {"
d
d
d
d
d
d
d
d
d
d
d
d
d
d
d
d
d
d
d
d
d
d
d
d
d
d
d
d
d
d
d
d
d
d
d
d
d
d
d
d
d
d
d
d
d
d
d
d
d
d
d
d
"}
