//MAP CONVERTED BY dmm2tgm.py THIS HEADER COMMENT PREVENTS RECONVERSION, DO NOT REMOVE
"a" = (
/turf/open/space/basic,
/area/space)
"b" = (
/obj/structure/table/wood/poker,
/turf/open/floor/carpet/royalblack,
/area/space)
"d" = (
/turf/open/floor/plasteel/mono,
/area/space)
"e" = (
/obj/structure/mineral_door/wood,
/turf/open/floor/plasteel/white,
/area/space)
"f" = (
/obj/structure/closet/secure_closet,
/turf/open/floor/plasteel/dark,
/area/space)
"h" = (
/turf/open/floor/plasteel/tech/grid,
/area/space)
"i" = (
/obj/structure/window/reinforced/spawner,
/turf/open/floor/plasteel/white,
/area/space)
"j" = (
/obj/structure/chair/sofa/corner{
	dir = 1
	},
/turf/open/floor/wood/walnut,
/area/space)
"k" = (
/turf/open/floor/wood/walnut,
/area/space)
"m" = (
/obj/structure/chair/sofa/corner{
	dir = 8
	},
/turf/open/floor/wood/walnut,
/area/space)
"o" = (
/obj/structure/chair/sofa/left{
	dir = 4
	},
/turf/open/floor/wood/walnut,
/area/space)
"p" = (
/obj/effect/spawner/structure/window/reinforced,
/turf/open/floor/plating,
/area/space)
"q" = (
/obj/machinery/door/window,
/turf/open/floor/plasteel/white,
/area/space)
"r" = (
/obj/machinery/power/smes,
/turf/open/floor/plating,
/area/space)
"s" = (
/obj/machinery/door/airlock/glass,
/turf/open/floor/wood/walnut,
/area/space)
"t" = (
/obj/machinery/power/shuttle/engine/electric{
	dir = 1
	},
/turf/open/floor/plating,
/area/space)
"v" = (
/turf/open/floor/plasteel/dark,
/area/space)
"x" = (
/obj/machinery/door/airlock/vault,
/turf/open/floor/vault,
/area/space)
"z" = (
/obj/machinery/computer/cryopod{
	dir = 4;
	pixel_x = -24
	},
/turf/open/floor/plasteel/dark,
/area/space)
"B" = (
/obj/structure/chair/sofa{
	dir = 1
	},
/turf/open/floor/wood/walnut,
/area/space)
"C" = (
/obj/structure/table/wood,
/turf/open/floor/wood/walnut,
/area/space)
"D" = (
/obj/machinery/door/airlock/external,
/turf/open/floor/plating,
/area/space)
"E" = (
/obj/machinery/door/airlock/external,
/turf/open/floor/plasteel/mono,
/area/space)
"F" = (
/obj/machinery/power/smes/shuttle/precharged{
	dir = 1
	},
/turf/open/floor/plating,
/area/space)
"H" = (
/obj/structure/table/wood,
/turf/open/floor/plasteel/dark,
/area/space)
"I" = (
/obj/machinery/door/airlock/glass,
/turf/open/floor/plating,
/area/space)
"K" = (
/turf/open/floor/plasteel/white,
/area/space)
"L" = (
/obj/machinery/vending/autodrobe,
/turf/open/floor/wood/walnut,
/area/space)
"M" = (
/obj/machinery/door/airlock/hatch,
/turf/open/floor/wood/walnut,
/area/space)
"N" = (
/obj/structure/chair/sofa/right{
	dir = 8
	},
/turf/open/floor/wood/walnut,
/area/space)
"O" = (
/turf/closed/wall/r_wall,
/area/space)
"P" = (
/obj/structure/railing/corner{
	dir = 1
	},
/turf/open/floor/plasteel/tech/grid,
/area/space)
"Q" = (
/obj/structure/chair/sofa{
	dir = 1
	},
/obj/structure/chair/sofa{
	dir = 1
	},
/turf/open/floor/wood/walnut,
/area/space)
"R" = (
/obj/machinery/cryopod{
	dir = 1
	},
/turf/open/floor/plasteel/dark,
/area/space)
"T" = (
/obj/structure/railing{
	dir = 8
	},
/turf/open/floor/plasteel/tech/grid,
/area/space)
"U" = (
/obj/machinery/door/airlock/glass,
/turf/open/floor/plasteel/dark,
/area/space)
"V" = (
/turf/open/floor/vault,
/area/space)
"W" = (
/obj/structure/bed,
/turf/open/floor/carpet/royalblack,
/area/space)
"X" = (
/turf/open/floor/plating,
/area/space)
"Z" = (
/obj/structure/railing/corner{
	dir = 8
	},
/turf/open/floor/plasteel/tech/grid,
/area/space)

(1,1,1) = {"
a
a
a
a
a
a
a
a
a
a
a
a
a
a
a
a
a
a
a
a
a
a
a
a
X
O
a
a
a
a
a
a
a
a
a
a
a
a
a
a
a
a
a
a
"}
(2,1,1) = {"
a
a
a
a
a
a
a
a
a
a
a
a
a
a
a
a
a
a
a
a
a
a
a
a
a
a
a
a
a
a
a
a
a
a
a
a
a
a
a
a
a
a
a
a
"}
(3,1,1) = {"
a
a
a
a
a
a
a
a
a
a
a
a
a
a
a
a
a
a
a
a
a
a
a
a
a
a
a
a
a
a
a
a
a
a
a
a
a
a
a
a
a
a
a
a
"}
(4,1,1) = {"
a
a
a
a
a
a
a
a
a
a
a
a
a
a
a
a
a
a
a
a
a
a
a
a
a
a
a
a
a
a
a
a
a
a
a
a
a
a
a
a
a
a
a
a
"}
(5,1,1) = {"
a
a
a
a
a
a
a
a
a
a
a
a
a
a
a
a
a
a
a
a
a
a
a
a
a
a
a
a
a
a
a
a
a
a
a
a
a
a
a
a
a
a
a
a
"}
(6,1,1) = {"
a
a
a
a
a
a
a
a
a
a
a
a
a
a
a
O
O
O
O
O
O
O
O
O
O
O
O
O
O
O
a
a
a
a
a
a
a
a
a
a
a
a
a
a
"}
(7,1,1) = {"
a
a
a
a
a
a
a
a
a
a
a
a
a
a
O
O
k
o
j
O
z
R
O
K
K
O
X
X
X
O
O
O
O
O
O
O
a
a
a
a
a
a
a
a
"}
(8,1,1) = {"
a
a
a
a
a
a
a
a
a
a
a
a
a
O
O
i
k
b
B
O
v
H
O
K
K
O
X
X
X
X
O
X
X
X
X
X
a
a
a
a
a
a
a
a
"}
(9,1,1) = {"
a
a
a
a
a
a
a
a
a
a
a
a
O
O
K
q
k
b
Q
O
v
H
O
K
K
O
X
X
X
X
X
X
X
X
X
X
a
a
a
a
a
a
a
a
"}
(10,1,1) = {"
a
a
a
a
a
a
a
a
a
a
a
a
O
K
K
i
k
b
B
O
I
O
O
O
e
O
O
O
O
X
O
O
O
O
O
O
a
a
a
a
a
a
a
a
"}
(11,1,1) = {"
a
a
a
a
a
a
a
a
a
a
a
a
O
O
O
O
k
N
m
O
h
h
h
h
h
h
h
h
h
h
O
d
d
d
O
a
a
a
a
a
a
a
a
a
"}
(12,1,1) = {"
a
a
a
a
a
a
a
a
a
a
a
a
p
v
v
O
Z
T
T
P
h
h
h
h
h
h
h
h
h
h
E
d
d
d
E
a
a
a
a
a
a
a
a
a
"}
(13,1,1) = {"
a
a
a
a
a
a
a
a
a
a
a
a
p
v
v
U
h
h
h
h
h
O
O
s
O
O
h
h
h
h
E
d
d
d
E
a
a
a
a
a
a
a
a
a
"}
(14,1,1) = {"
a
a
a
a
a
a
a
a
a
a
a
a
p
v
v
O
M
O
O
x
O
O
f
k
W
O
h
h
h
h
O
d
d
d
O
a
a
a
a
a
a
a
a
a
"}
(15,1,1) = {"
a
a
a
a
a
a
a
a
a
a
a
a
O
O
O
O
k
O
V
V
V
O
f
k
W
O
O
O
O
X
O
O
O
O
O
O
a
a
a
a
a
a
a
a
"}
(16,1,1) = {"
a
a
a
a
a
a
a
a
a
a
a
a
O
O
k
k
k
O
V
V
V
O
f
k
W
O
X
X
X
X
X
X
X
X
X
X
a
a
a
a
a
a
a
a
"}
(17,1,1) = {"
a
a
a
a
a
a
a
a
a
a
a
a
a
O
O
k
k
O
V
V
V
O
f
k
W
O
X
X
X
X
O
X
X
X
X
X
a
a
a
a
a
a
a
a
"}
(18,1,1) = {"
a
a
a
a
a
a
a
a
a
a
a
a
a
a
O
O
k
O
V
V
V
O
L
k
C
O
X
X
X
O
O
O
O
O
O
O
a
a
a
a
a
a
a
a
"}
(19,1,1) = {"
a
a
a
a
a
a
a
a
a
a
a
a
a
a
a
O
O
O
O
O
O
O
O
O
O
O
O
O
O
O
a
a
a
a
a
a
a
a
a
a
a
a
a
a
"}
(20,1,1) = {"
a
a
a
a
a
a
a
a
a
a
a
a
a
a
a
a
a
a
a
a
a
a
a
a
a
a
a
a
a
a
a
a
a
a
a
a
a
a
a
a
a
a
a
a
"}
(21,1,1) = {"
a
a
a
a
a
a
a
a
a
a
a
a
a
a
a
a
a
a
a
a
a
a
a
a
a
a
a
a
a
a
a
a
a
a
a
a
a
a
a
a
a
a
a
a
"}
(22,1,1) = {"
a
a
a
a
a
a
a
a
a
a
a
a
a
a
a
a
a
a
a
a
a
a
a
a
a
a
a
a
a
a
a
a
a
a
a
a
a
a
a
a
a
a
a
a
"}
(23,1,1) = {"
a
a
a
a
a
a
a
a
a
a
a
a
a
a
a
a
a
a
a
a
a
a
a
a
a
a
a
a
a
a
a
a
a
a
a
a
a
a
a
a
a
a
a
a
"}
(24,1,1) = {"
a
a
a
a
a
a
a
a
a
a
a
a
a
a
a
a
a
a
a
a
a
a
a
a
a
a
a
a
a
a
a
a
a
a
a
a
a
a
a
a
a
a
a
a
"}
(25,1,1) = {"
a
a
a
a
a
a
a
a
a
a
a
a
a
a
a
a
a
a
a
a
a
a
a
a
a
a
a
a
a
a
a
a
a
a
a
a
a
a
a
a
a
a
a
a
"}
(26,1,1) = {"
a
a
a
a
a
a
a
a
a
a
a
a
a
a
a
a
a
a
a
a
a
a
a
a
a
a
a
a
a
a
a
a
a
a
a
a
a
a
a
a
a
a
a
a
"}
(27,1,1) = {"
a
a
a
a
a
a
a
a
a
a
a
a
a
a
a
a
a
a
a
a
a
a
a
a
a
a
a
a
a
a
a
a
a
a
a
a
a
a
a
a
a
a
a
a
"}
(28,1,1) = {"
a
a
a
a
a
a
a
a
a
a
a
a
a
a
a
a
a
a
a
a
a
a
a
a
a
a
a
a
a
a
a
a
a
a
a
a
a
a
a
a
a
a
a
a
"}
(29,1,1) = {"
a
a
a
a
a
O
O
O
O
O
O
O
O
a
a
a
a
a
a
a
a
a
a
a
a
a
a
a
a
a
O
O
O
O
O
a
a
a
a
a
a
a
a
a
"}
(30,1,1) = {"
a
a
a
a
a
O
X
X
O
X
X
X
O
a
a
a
a
a
a
a
a
a
a
a
a
a
a
O
O
O
O
X
X
F
t
a
a
a
a
a
a
a
a
a
"}
(31,1,1) = {"
a
a
a
O
O
O
X
X
O
X
X
X
O
a
a
a
a
a
O
O
O
O
O
O
O
O
O
O
X
X
O
X
X
F
t
a
a
a
a
a
a
a
a
a
"}
(32,1,1) = {"
a
a
O
O
X
O
X
X
O
X
X
X
O
a
a
a
a
O
O
X
X
X
X
X
X
X
X
O
X
X
O
X
X
F
t
a
a
a
a
a
a
a
a
a
"}
(33,1,1) = {"
a
a
O
X
X
O
O
X
O
X
X
X
O
a
a
a
O
O
X
X
X
X
X
X
X
X
X
O
X
X
O
X
X
r
O
a
a
a
a
a
a
a
a
a
"}
(34,1,1) = {"
a
a
O
X
X
X
O
X
O
X
X
X
O
a
a
a
O
X
X
X
X
X
X
X
X
X
X
O
O
X
O
X
O
O
O
O
O
O
a
a
a
a
a
a
"}
(35,1,1) = {"
a
a
O
X
X
X
O
X
O
O
X
O
O
a
a
a
O
X
X
X
X
X
X
X
X
X
X
X
X
X
O
X
X
O
X
X
X
O
X
a
a
a
a
a
"}
(36,1,1) = {"
a
a
O
X
X
O
O
X
X
X
X
X
X
a
a
a
O
X
X
X
X
X
X
X
X
X
X
X
O
X
X
X
X
D
X
X
X
D
X
a
a
a
a
a
"}
(37,1,1) = {"
a
a
O
X
X
X
X
X
X
X
X
X
X
a
p
p
O
X
X
X
X
X
X
X
X
X
X
X
O
X
X
X
X
D
X
X
X
D
X
a
a
a
a
a
"}
(38,1,1) = {"
p
p
O
O
O
O
X
O
O
O
X
O
O
p
p
X
O
O
X
X
X
X
X
X
X
X
X
X
X
X
O
X
X
O
X
X
X
O
X
a
a
a
a
a
"}
(39,1,1) = {"
p
X
X
X
X
X
X
O
X
X
X
X
O
p
X
X
X
O
X
X
X
O
O
O
O
O
O
O
O
X
O
X
O
O
O
O
O
O
a
a
a
a
a
a
"}
(40,1,1) = {"
p
X
X
X
O
O
O
O
X
X
X
X
O
p
X
X
X
X
X
X
X
O
X
X
O
X
X
X
X
X
O
X
X
X
O
a
a
a
a
a
a
a
a
a
"}
(41,1,1) = {"
p
X
X
X
O
X
X
O
X
X
X
X
O
p
X
X
X
O
X
X
X
O
X
X
X
X
X
X
X
X
O
X
X
F
t
a
a
a
a
a
a
a
a
a
"}
(42,1,1) = {"
p
p
X
X
O
X
X
X
X
X
X
X
O
p
p
p
p
O
O
O
O
O
X
X
O
X
X
X
X
X
O
X
X
F
t
a
a
a
a
a
a
a
a
a
"}
(43,1,1) = {"
a
p
p
p
O
X
X
O
X
X
X
X
O
a
a
a
a
a
a
a
a
O
O
O
O
O
O
O
O
O
O
X
X
F
t
a
a
a
a
a
a
a
a
a
"}
(44,1,1) = {"
a
a
a
a
O
O
O
O
O
O
O
O
O
a
a
a
a
a
a
a
a
a
a
a
a
a
a
a
a
a
O
O
O
O
O
a
a
a
a
a
a
a
a
a
"}
