//MAP CONVERTED BY dmm2tgm.py THIS HEADER COMMENT PREVENTS RECONVERSION, DO NOT REMOVE
"a" = (
/turf/open/floor/plating/asteroid,
/area/space)
"b" = (
/turf/open/floor/noslip,
/area/space)
"e" = (
/mob/living/silicon/ai,
/turf/open/floor/circuit/red,
/area/space)
"g" = (
/turf/closed/wall/mineral/plastitanium/nodiagonal,
/area/space)
"k" = (
/turf/open/floor/plasteel,
/area/space)
"l" = (
/turf/open/floor/mineral/plastitanium/red,
/area/space)
"o" = (
/turf/open/floor/carpet/red_gold,
/area/space)
"s" = (
/turf/open/floor/plasteel/grimy,
/area/space)
"t" = (
/obj/item/keycard,
/turf/open/floor/plasteel/tech/techmaint,
/area/space)
"v" = (
/turf/open/floor/carpet/red,
/area/space)
"A" = (
/mob/living/silicon/robot/modules/syndicate/saboteur,
/turf/open/floor/plasteel/tech/techmaint,
/area/space)
"B" = (
/mob/living/simple_animal/hostile/syndicate/mecha_pilot,
/turf/open/floor/plating/asteroid,
/area/space)
"E" = (
/obj/machinery/door/keycard,
/turf/open/floor/plasteel,
/area/space)
"I" = (
/turf/closed/mineral/random/asteroid/rockplanet,
/area/space)
"K" = (
/mob/living/silicon/robot/modules/syndicate,
/turf/open/floor/plasteel/tech/techmaint,
/area/space)
"O" = (
/turf/open/floor/circuit/red,
/area/space)
"Q" = (
/turf/open/floor/plasteel/tech,
/area/space)
"V" = (
/turf/open/floor/plasteel/tech/techmaint,
/area/space)
"W" = (
/turf/open/floor/eighties,
/area/space)
"Z" = (
/obj/item/keycard,
/turf/open/floor/plasteel,
/area/space)

(1,1,1) = {"
a
a
a
a
a
a
a
a
a
a
a
a
a
a
a
a
a
a
a
a
a
a
a
a
a
a
a
a
a
a
a
a
a
a
a
a
a
a
a
a
a
a
a
a
a
a
a
a
a
a
a
a
a
a
a
a
a
a
a
a
"}
(2,1,1) = {"
a
a
a
a
a
a
a
a
a
a
a
a
a
a
a
a
a
a
a
a
a
a
a
a
a
a
a
a
a
a
a
a
a
a
a
a
a
a
a
a
a
a
a
a
a
a
a
a
a
a
a
a
a
a
a
a
a
a
a
a
"}
(3,1,1) = {"
a
a
a
a
a
a
a
a
a
a
a
a
a
a
a
a
a
a
a
a
a
a
a
a
a
a
a
a
a
a
a
a
a
a
a
a
a
a
a
a
a
a
a
a
a
a
a
a
a
a
a
a
a
a
a
a
a
a
a
a
"}
(4,1,1) = {"
a
a
a
a
a
a
a
a
a
a
a
a
a
a
a
a
a
a
a
a
a
a
a
a
a
a
a
I
I
I
I
I
I
I
a
a
a
a
a
a
a
a
a
a
a
a
a
a
a
a
a
a
a
a
a
a
a
a
a
a
"}
(5,1,1) = {"
a
a
a
a
a
a
a
a
a
a
a
a
a
a
a
a
a
a
a
a
a
a
a
a
I
I
I
I
I
I
I
I
I
I
I
I
I
I
I
I
I
I
I
I
I
a
a
a
a
a
a
a
a
a
a
a
a
a
a
a
"}
(6,1,1) = {"
a
a
a
a
a
a
a
a
a
a
a
a
a
a
a
a
a
a
a
a
a
a
a
a
I
I
I
I
I
I
I
I
I
I
I
I
I
I
I
I
I
I
I
I
I
a
a
a
a
a
a
a
a
a
a
a
a
a
a
a
"}
(7,1,1) = {"
a
a
a
a
a
a
a
a
a
a
I
I
I
I
I
I
I
a
I
I
I
I
I
I
I
I
I
I
I
I
I
I
I
I
I
I
I
I
I
I
I
I
I
I
I
I
a
a
a
a
a
a
a
a
a
a
a
a
a
a
"}
(8,1,1) = {"
a
a
a
a
a
a
a
a
a
a
I
I
I
I
I
I
I
I
I
I
I
I
I
I
I
I
I
I
I
I
I
I
I
I
I
I
I
I
I
I
I
I
I
I
I
I
a
a
a
a
a
a
a
a
a
a
a
a
a
a
"}
(9,1,1) = {"
a
a
a
a
a
a
a
a
a
I
I
I
I
I
I
I
I
I
I
I
I
I
I
I
I
I
I
I
I
I
I
I
I
I
I
I
I
I
I
I
I
I
I
I
I
I
I
I
I
I
I
I
I
I
a
a
a
a
a
a
"}
(10,1,1) = {"
a
a
a
a
a
a
a
a
a
I
I
I
I
I
I
I
I
I
I
I
I
I
I
I
I
I
I
I
I
I
I
I
I
I
I
I
I
I
I
I
I
I
I
I
I
I
I
I
I
I
I
I
I
I
a
a
a
a
a
a
"}
(11,1,1) = {"
a
a
a
a
a
a
a
I
I
I
I
I
I
I
I
I
I
I
I
I
I
I
I
I
I
I
I
I
I
I
I
I
I
I
I
I
I
I
I
I
I
I
I
I
I
I
I
I
I
I
I
I
I
I
a
a
a
a
a
a
"}
(12,1,1) = {"
a
a
a
a
a
a
a
I
I
I
I
I
I
I
I
I
I
I
I
I
I
I
I
I
I
I
I
I
I
I
I
I
I
I
I
I
I
I
I
I
I
I
I
I
I
I
I
I
I
I
I
I
I
I
a
a
a
a
a
a
"}
(13,1,1) = {"
a
a
a
a
a
a
a
I
I
I
I
I
I
I
I
I
I
I
I
a
a
a
a
a
a
a
a
a
a
a
a
a
a
a
a
a
a
a
a
I
I
I
I
I
I
I
I
I
I
I
I
I
I
I
a
a
a
a
a
a
"}
(14,1,1) = {"
a
a
a
a
a
a
a
I
I
I
I
I
I
I
I
I
I
I
I
a
a
a
a
a
a
a
a
a
a
a
a
a
a
a
a
a
a
a
a
a
a
a
a
a
a
a
I
I
I
I
I
I
I
I
I
I
I
a
a
a
"}
(15,1,1) = {"
a
a
a
a
a
a
a
I
I
I
I
I
I
I
I
a
a
a
a
a
a
a
a
a
a
a
a
a
a
a
a
a
a
a
a
a
a
a
a
a
a
a
a
a
a
a
a
a
I
I
I
I
I
I
I
I
I
a
a
a
"}
(16,1,1) = {"
a
a
a
a
a
a
a
I
I
I
I
I
I
a
a
a
a
a
a
a
a
a
a
a
a
a
a
a
a
a
a
a
a
a
a
a
a
a
a
a
a
a
a
a
a
a
a
a
I
I
I
I
I
I
I
I
I
a
a
a
"}
(17,1,1) = {"
a
a
a
a
a
a
I
I
I
I
I
I
I
a
a
a
a
a
a
a
g
g
g
g
g
g
g
g
g
g
g
g
g
g
g
g
g
g
g
a
a
a
a
a
a
a
a
a
I
I
I
I
I
I
I
I
I
a
a
a
"}
(18,1,1) = {"
a
a
a
a
a
a
I
I
I
I
I
I
I
a
a
a
g
g
g
g
g
k
k
k
k
g
k
k
k
k
g
k
k
k
k
k
k
k
g
a
a
a
a
a
a
a
a
a
a
a
I
I
I
I
I
I
I
a
a
a
"}
(19,1,1) = {"
a
a
a
a
a
a
I
I
I
I
I
I
I
a
a
a
g
k
k
k
g
g
k
k
k
g
k
k
k
k
k
k
k
k
k
k
k
g
g
g
g
g
g
g
g
g
a
a
a
a
I
I
I
I
I
I
I
a
a
a
"}
(20,1,1) = {"
a
a
a
a
a
a
I
I
I
I
I
I
I
a
a
g
g
k
k
k
k
g
k
k
k
g
k
k
k
k
g
k
k
k
k
k
k
g
V
V
V
V
t
V
V
g
a
a
a
a
a
a
I
I
I
I
I
a
a
a
"}
(21,1,1) = {"
a
a
a
a
a
a
I
I
I
I
I
I
I
a
a
g
k
k
k
k
k
g
k
k
k
g
k
k
k
k
g
k
k
k
k
k
k
g
V
V
V
V
g
V
V
g
g
g
a
a
a
a
I
I
I
I
I
a
a
a
"}
(22,1,1) = {"
a
a
a
a
a
a
I
I
I
I
I
I
I
a
a
g
k
k
k
k
k
g
k
k
k
k
k
k
k
k
g
g
g
g
k
g
g
g
V
V
V
V
g
V
V
V
V
g
a
a
a
a
I
I
I
I
I
a
a
a
"}
(23,1,1) = {"
a
a
a
a
a
a
I
I
I
I
I
I
a
a
a
g
k
k
k
k
k
g
k
k
k
g
k
k
k
k
g
k
k
k
k
k
k
g
V
V
V
O
O
O
V
V
V
g
a
a
a
a
I
I
I
I
I
a
a
a
"}
(24,1,1) = {"
a
a
a
a
a
a
I
I
I
I
I
I
a
a
a
g
k
k
k
k
k
g
k
k
k
g
k
k
k
k
g
k
k
k
k
k
k
g
V
g
g
O
e
O
g
g
V
g
a
a
a
a
I
I
I
I
I
a
a
a
"}
(25,1,1) = {"
a
a
a
a
a
a
I
I
I
I
I
I
a
a
a
g
k
k
k
k
k
g
k
k
k
g
k
k
k
k
g
Z
k
k
k
k
k
g
V
V
V
O
O
O
V
V
V
g
a
a
a
a
I
I
I
I
I
a
a
a
"}
(26,1,1) = {"
a
a
a
a
a
a
I
I
I
I
I
I
a
a
a
g
k
k
k
k
k
g
g
g
g
g
g
g
l
g
g
g
g
g
g
g
g
g
V
V
V
V
g
V
V
V
V
g
a
a
a
a
I
I
I
I
I
a
a
a
"}
(27,1,1) = {"
a
a
a
a
a
a
I
I
I
I
I
I
a
a
a
g
k
k
k
k
k
g
l
l
l
l
l
l
l
l
l
l
l
l
l
l
l
g
V
V
V
A
g
K
V
V
V
g
a
a
a
a
I
I
I
I
I
a
a
a
"}
(28,1,1) = {"
a
a
a
a
a
I
I
I
I
I
I
I
a
a
a
g
k
k
k
k
k
l
l
l
l
l
l
l
l
l
l
l
l
l
l
l
l
g
V
V
V
V
V
V
V
V
V
g
a
a
a
a
I
I
I
I
I
a
a
a
"}
(29,1,1) = {"
a
a
a
a
a
I
I
I
I
I
I
I
a
a
a
g
k
k
k
k
k
g
l
l
g
g
g
g
g
g
g
g
g
g
g
l
l
g
V
V
V
V
V
V
V
V
V
g
a
a
a
a
I
I
I
I
a
a
a
a
"}
(30,1,1) = {"
a
a
a
a
a
I
I
I
I
I
I
I
a
a
a
g
k
k
k
k
k
g
l
l
g
k
k
k
k
k
k
k
k
k
g
l
l
g
V
V
V
V
V
V
V
V
V
g
a
a
a
a
I
I
I
I
a
a
a
a
"}
(31,1,1) = {"
a
a
a
a
a
I
I
I
I
I
I
I
a
a
a
g
k
k
k
k
k
g
l
l
g
k
k
k
k
k
k
k
k
k
g
l
l
g
g
V
V
V
V
V
V
V
V
g
a
a
a
a
I
I
I
I
a
a
a
a
"}
(32,1,1) = {"
a
a
a
a
a
I
I
I
I
I
I
I
a
a
a
g
g
g
g
g
g
g
l
l
g
k
k
k
k
k
k
k
k
k
g
l
l
l
g
V
V
V
V
V
V
g
g
g
a
a
a
a
I
I
I
I
a
a
a
a
"}
(33,1,1) = {"
a
a
a
a
a
I
I
I
I
I
I
a
a
a
a
a
a
g
k
k
k
g
l
l
g
k
k
k
k
k
k
k
k
k
g
l
l
l
g
g
g
g
V
g
g
g
a
a
a
a
a
a
I
I
I
I
a
a
a
a
"}
(34,1,1) = {"
a
a
a
a
I
I
I
I
I
I
I
a
a
a
a
a
a
g
k
k
k
g
l
l
g
k
k
k
k
k
k
k
k
k
g
g
l
l
g
k
k
k
k
k
k
g
a
a
a
a
a
a
I
I
I
I
a
a
a
a
"}
(35,1,1) = {"
a
a
a
a
I
I
I
I
I
I
I
a
a
a
a
a
a
g
k
k
k
g
g
g
g
g
g
k
k
k
k
k
k
k
k
g
l
l
g
k
k
k
k
k
k
g
a
a
a
a
I
I
I
I
I
I
a
a
a
a
"}
(36,1,1) = {"
a
a
a
a
I
I
I
I
I
I
I
a
a
a
a
a
a
g
k
k
k
g
k
k
k
k
g
k
k
k
k
k
k
k
k
g
l
l
g
k
k
k
k
k
k
g
a
a
a
a
I
I
I
I
I
I
a
a
a
a
"}
(37,1,1) = {"
a
a
a
a
I
I
I
I
I
I
I
a
a
a
a
a
a
g
k
k
k
k
k
k
k
k
g
k
k
k
k
k
k
k
k
g
l
l
g
k
k
k
k
k
k
g
a
a
a
a
I
I
I
I
I
a
a
a
a
a
"}
(38,1,1) = {"
a
a
a
a
I
I
I
I
I
I
I
a
a
a
a
a
a
g
k
k
k
g
k
k
k
k
g
g
g
g
g
g
g
l
g
g
l
l
g
k
k
k
k
k
k
g
a
a
a
a
I
I
I
I
I
a
a
a
a
a
"}
(39,1,1) = {"
a
a
a
a
I
I
I
I
I
I
I
a
a
a
a
a
a
g
k
k
k
g
k
k
k
k
g
k
k
k
k
k
g
l
l
l
l
l
g
k
k
k
k
k
k
g
a
a
a
a
I
I
I
I
I
a
a
a
a
a
"}
(40,1,1) = {"
a
a
a
a
I
I
I
I
I
I
I
a
a
a
a
a
a
g
k
k
k
g
k
k
k
k
g
k
k
k
k
k
l
l
l
l
l
l
g
k
k
k
k
k
k
g
a
a
a
a
I
I
I
I
I
a
a
a
a
a
"}
(41,1,1) = {"
a
a
a
a
I
I
I
I
I
I
I
a
a
g
g
g
g
g
g
k
k
g
k
k
k
k
k
k
k
k
k
k
g
g
g
g
g
g
g
k
k
k
k
k
k
g
a
a
a
a
I
I
I
I
I
a
a
a
a
a
"}
(42,1,1) = {"
a
a
a
a
I
I
I
I
I
I
I
a
a
g
W
W
W
W
g
g
g
g
g
k
g
g
g
k
k
k
k
k
g
k
k
k
k
g
k
k
k
k
k
k
k
g
a
a
a
a
I
I
I
I
I
I
a
a
a
a
"}
(43,1,1) = {"
a
a
a
a
I
I
I
I
I
I
I
a
a
g
W
W
W
W
v
o
v
v
o
v
v
o
g
k
k
k
k
k
g
k
k
k
k
g
k
k
k
k
k
k
k
g
a
a
a
a
I
I
I
I
I
I
a
a
a
a
"}
(44,1,1) = {"
a
a
a
a
I
I
I
I
I
I
a
a
a
g
W
W
W
W
v
v
o
v
v
o
v
v
g
g
g
g
g
g
g
k
k
k
k
g
k
k
k
k
k
k
k
g
a
a
a
a
I
I
I
I
I
I
a
a
a
a
"}
(45,1,1) = {"
a
a
a
a
I
I
I
I
I
I
a
a
a
g
W
W
W
W
v
o
v
v
o
v
o
v
g
l
l
l
l
l
g
k
k
k
k
g
k
k
k
k
k
k
k
g
a
a
a
a
I
I
I
I
I
I
a
a
a
a
"}
(46,1,1) = {"
a
a
a
a
I
I
I
I
I
I
a
a
a
g
W
W
W
W
o
v
v
o
v
o
v
v
g
l
l
l
l
l
g
k
k
k
k
g
k
k
k
k
k
k
k
g
a
a
a
a
I
I
I
I
I
I
a
a
a
a
"}
(47,1,1) = {"
a
a
a
a
I
I
I
I
I
I
a
a
a
g
g
g
v
o
v
o
v
v
v
v
v
o
k
l
l
l
l
l
g
k
k
k
k
g
g
g
g
k
k
g
g
g
a
a
a
a
I
I
I
I
I
I
a
a
a
a
"}
(48,1,1) = {"
a
a
a
a
I
I
I
I
I
I
a
a
a
a
a
g
v
v
o
v
o
v
o
v
o
v
k
l
l
l
l
l
g
k
k
k
k
k
g
k
k
k
k
k
k
g
a
a
a
a
I
I
I
I
I
I
a
a
a
a
"}
(49,1,1) = {"
a
a
a
I
I
I
I
I
I
I
a
a
a
a
a
g
v
v
v
o
s
s
s
s
s
s
g
l
l
l
l
l
g
k
k
k
k
k
g
k
k
k
k
k
k
g
a
a
a
a
I
I
I
I
I
I
a
a
a
a
"}
(50,1,1) = {"
a
a
a
I
I
I
I
I
I
I
a
a
a
a
a
g
o
v
o
v
s
s
s
s
s
s
g
l
l
l
l
l
g
k
k
k
k
k
k
k
k
k
k
k
k
g
a
a
a
a
I
I
I
I
I
I
a
a
a
a
"}
(51,1,1) = {"
a
a
a
I
I
I
I
I
I
I
a
a
a
a
a
g
v
o
v
o
s
s
s
s
s
s
g
l
l
l
l
l
g
k
k
k
k
k
g
k
k
k
k
k
k
g
a
a
a
a
I
I
I
I
I
I
a
a
a
a
"}
(52,1,1) = {"
a
a
a
I
I
I
I
I
I
I
a
a
a
a
a
g
g
Q
g
g
g
g
g
g
g
g
g
g
l
l
l
l
g
k
k
k
k
k
g
k
k
k
k
k
k
g
a
a
a
a
I
I
I
I
I
I
a
a
a
a
"}
(53,1,1) = {"
a
a
a
I
I
I
I
I
I
I
a
a
a
a
a
g
Q
Q
Q
g
k
k
k
g
k
k
k
g
l
l
l
l
g
g
g
k
g
g
g
k
k
k
k
k
k
g
a
a
a
a
I
I
I
I
I
I
a
a
a
a
"}
(54,1,1) = {"
a
a
I
I
I
I
I
I
I
I
a
a
g
g
g
g
Q
Q
Q
g
k
k
k
g
k
k
k
g
l
l
l
l
g
k
k
k
k
k
g
k
k
k
k
k
k
g
a
a
a
a
I
I
I
I
I
I
a
a
a
a
"}
(55,1,1) = {"
a
a
I
I
I
I
I
I
I
I
a
a
g
Q
Q
Q
Q
Q
Q
g
k
k
k
g
k
k
k
g
l
l
l
l
g
k
k
k
k
k
g
k
k
k
k
k
k
g
a
a
a
a
I
I
I
I
I
I
a
a
a
a
"}
(56,1,1) = {"
a
a
I
I
I
I
I
I
I
I
a
a
g
Q
Q
Q
Q
Q
Q
g
k
k
k
g
k
k
k
g
l
l
l
l
g
k
k
k
k
k
g
k
k
k
k
k
k
g
a
a
a
a
I
I
I
I
I
I
a
a
a
a
"}
(57,1,1) = {"
a
a
I
I
I
I
I
I
I
I
a
a
g
Q
Q
Q
Q
Q
Q
g
k
k
k
g
k
k
k
g
l
l
l
l
g
k
k
k
k
k
g
k
k
k
k
k
k
g
a
a
a
a
I
I
I
I
I
I
a
a
a
a
"}
(58,1,1) = {"
a
a
I
I
I
I
I
I
I
a
a
a
g
Q
Q
g
g
Q
g
g
k
k
k
g
k
k
k
g
l
l
l
l
k
k
k
k
k
k
g
k
k
k
k
k
k
g
a
a
a
a
I
I
I
I
I
I
a
a
a
a
"}
(59,1,1) = {"
a
a
I
I
I
I
I
I
I
a
a
a
g
Q
Q
g
l
l
l
g
g
k
g
g
g
k
g
g
l
l
l
l
g
k
k
k
k
k
g
k
k
k
k
k
k
g
a
a
a
a
I
I
I
I
I
I
a
a
a
a
"}
(60,1,1) = {"
a
a
I
I
I
I
I
I
I
a
a
a
g
Q
Q
g
l
l
l
l
l
l
l
l
l
l
l
g
l
l
l
l
g
k
k
k
k
k
g
g
g
g
g
g
g
g
a
a
a
a
I
I
I
I
I
I
a
a
a
a
"}
(61,1,1) = {"
a
a
I
I
I
I
I
I
I
a
a
a
g
Q
Q
g
l
l
l
l
l
l
l
l
l
l
l
l
l
l
l
l
g
k
k
k
k
k
k
g
k
k
k
k
k
g
a
a
a
a
I
I
I
I
I
I
a
a
a
a
"}
(62,1,1) = {"
a
a
I
I
I
I
I
I
I
a
a
a
g
Q
Q
g
l
l
l
l
l
l
l
l
l
l
l
g
l
l
l
l
g
k
k
k
k
k
k
g
k
k
k
k
k
g
a
a
a
a
I
I
I
I
I
I
a
a
a
a
"}
(63,1,1) = {"
a
a
I
I
I
I
I
I
I
a
a
a
g
Q
Q
g
o
v
v
g
g
g
k
g
g
g
g
g
l
l
l
l
g
k
k
k
k
k
k
k
k
k
k
k
k
g
a
a
a
a
I
I
I
I
I
I
a
a
a
a
"}
(64,1,1) = {"
a
a
I
I
I
I
I
I
I
a
a
a
g
Q
Q
g
v
v
o
g
k
k
k
k
k
k
k
g
l
l
l
l
g
k
k
k
k
k
k
g
k
k
k
k
k
g
a
a
a
a
I
I
I
I
I
I
a
a
a
a
"}
(65,1,1) = {"
a
a
I
I
I
I
I
I
I
a
a
a
g
Q
Q
g
v
o
v
g
k
k
k
k
k
k
k
g
l
l
l
l
g
k
k
k
k
k
k
g
k
k
k
k
k
g
a
a
a
a
I
I
I
I
I
I
a
a
a
a
"}
(66,1,1) = {"
a
a
I
I
I
I
I
I
I
a
a
a
g
Q
Q
g
v
v
o
g
k
k
k
k
k
k
k
g
l
l
l
l
g
k
k
k
k
k
k
g
k
k
k
k
k
g
a
a
a
a
I
I
I
I
I
I
I
a
a
a
"}
(67,1,1) = {"
a
a
I
I
I
I
I
I
I
a
a
a
g
Q
Q
g
g
g
g
g
g
g
g
g
g
g
g
g
g
l
l
l
g
k
k
k
k
k
k
g
k
k
k
k
k
g
a
a
a
a
I
I
I
I
I
I
I
a
a
a
"}
(68,1,1) = {"
a
a
I
I
I
I
I
I
I
a
a
a
g
Q
Q
Q
Q
g
V
V
V
V
V
V
V
V
V
V
g
l
l
l
g
k
k
k
k
k
k
g
k
k
k
k
k
g
a
a
a
a
I
I
I
I
I
I
I
a
a
a
"}
(69,1,1) = {"
a
a
I
I
I
I
I
a
a
a
a
a
g
Q
Q
Q
Q
g
V
V
V
V
V
V
V
V
V
V
g
l
l
l
g
k
k
k
k
k
k
g
k
k
k
k
k
g
a
a
a
a
I
I
I
I
I
I
I
a
a
a
"}
(70,1,1) = {"
a
a
I
I
I
I
I
a
a
a
a
a
g
Q
Q
Q
Q
g
V
V
V
V
V
V
V
V
V
V
g
l
l
l
g
k
k
k
k
k
k
g
k
k
k
k
k
g
a
a
a
a
I
I
I
I
I
I
I
a
a
a
"}
(71,1,1) = {"
a
a
I
I
I
I
I
a
a
a
a
a
g
Q
Q
Q
Q
g
V
V
V
V
V
V
V
V
V
V
E
l
l
l
g
g
g
g
g
g
g
g
k
g
g
g
g
g
a
a
a
a
I
I
I
I
I
I
I
a
a
a
"}
(72,1,1) = {"
a
a
I
I
I
I
I
a
a
a
g
g
g
g
Q
g
g
g
V
V
V
V
V
V
V
V
V
V
g
l
l
l
g
k
k
k
k
k
g
k
k
k
k
k
k
g
a
a
a
a
I
I
I
I
I
I
I
a
a
a
"}
(73,1,1) = {"
a
a
I
I
I
I
I
a
a
a
g
k
k
k
k
b
b
g
V
V
V
V
V
V
V
V
V
V
g
l
l
l
g
k
k
k
k
k
g
k
k
k
k
k
k
g
a
a
a
a
I
I
I
I
I
I
I
a
a
a
"}
(74,1,1) = {"
a
a
I
I
I
I
I
a
a
a
g
k
k
k
k
b
b
g
V
V
V
V
V
V
V
V
V
V
g
l
l
l
k
k
k
k
k
k
g
k
k
k
k
k
k
g
a
a
a
a
I
I
I
I
I
I
I
a
a
a
"}
(75,1,1) = {"
a
a
I
I
I
I
I
a
a
a
g
k
k
k
k
b
b
g
V
V
V
V
V
V
V
V
V
V
g
l
l
l
g
k
k
k
k
k
g
k
k
k
k
k
k
g
a
a
a
a
I
I
I
I
I
I
I
a
a
a
"}
(76,1,1) = {"
a
a
I
I
I
I
I
a
a
a
g
k
k
k
k
b
b
g
V
V
V
V
V
V
V
V
V
V
g
l
l
l
g
k
k
k
k
k
g
k
k
k
k
k
k
g
a
a
a
a
I
I
I
I
I
I
I
I
a
a
"}
(77,1,1) = {"
a
a
I
I
I
I
I
a
a
a
g
k
k
k
k
b
b
g
V
V
V
V
V
V
V
V
V
V
g
l
l
l
g
g
g
k
g
g
g
k
k
k
k
k
k
g
a
a
a
a
I
I
I
I
I
I
I
I
a
a
"}
(78,1,1) = {"
a
a
I
I
I
I
I
a
a
a
g
k
k
k
k
b
b
g
V
V
V
V
V
V
V
V
V
V
g
l
l
l
g
k
k
k
k
g
k
k
k
k
k
k
k
g
a
a
a
a
I
I
I
I
I
I
I
I
a
a
"}
(79,1,1) = {"
a
a
I
I
I
I
I
a
a
a
g
k
k
k
k
b
b
g
V
V
V
V
V
V
V
V
V
V
g
l
l
l
g
k
k
k
k
g
k
k
k
k
k
k
k
g
a
a
a
a
I
I
I
I
I
I
I
I
a
a
"}
(80,1,1) = {"
a
a
I
I
I
I
I
a
a
a
g
k
k
k
k
b
b
g
V
V
V
V
V
V
V
V
V
V
g
l
l
l
g
k
k
k
k
k
k
k
k
k
k
k
g
g
a
a
a
a
I
I
I
I
I
I
I
I
a
a
"}
(81,1,1) = {"
a
a
I
I
I
I
I
a
a
a
g
k
k
k
k
b
b
g
V
V
V
V
V
V
V
V
V
V
g
l
l
l
g
k
k
k
k
g
k
k
k
k
k
k
g
a
a
a
a
a
I
I
I
I
I
I
I
I
a
a
"}
(82,1,1) = {"
a
a
I
I
I
I
I
a
a
a
g
k
k
k
k
k
k
E
V
V
V
V
V
V
V
V
V
V
g
l
l
l
g
k
k
k
k
g
k
k
g
g
g
g
g
a
a
a
a
a
I
I
I
I
I
I
I
I
a
a
"}
(83,1,1) = {"
a
a
I
I
I
I
I
a
a
a
g
k
k
k
k
k
k
g
V
V
V
V
V
V
V
V
V
V
g
l
l
l
g
g
g
g
g
g
k
g
g
k
k
k
g
a
a
a
a
a
I
I
I
I
I
I
I
I
a
a
"}
(84,1,1) = {"
a
a
I
I
I
I
I
a
a
a
g
g
g
g
g
Q
g
g
V
V
V
V
V
V
V
V
V
V
g
l
l
l
l
l
g
k
k
k
k
k
k
k
k
k
g
a
a
a
a
a
I
I
I
I
I
I
I
I
a
a
"}
(85,1,1) = {"
a
a
I
I
I
I
I
a
a
a
a
a
a
g
Q
Q
Q
g
V
V
V
V
V
V
V
V
V
V
g
l
l
l
l
l
g
k
k
k
k
k
g
k
k
k
g
a
a
a
a
a
I
I
I
I
I
I
I
I
a
a
"}
(86,1,1) = {"
a
a
I
I
I
I
I
a
a
a
a
a
a
g
Q
Q
Q
g
g
g
g
g
g
g
g
g
g
g
g
l
l
l
l
l
g
k
k
k
k
k
g
k
k
k
g
a
a
a
a
a
I
I
I
I
I
I
I
I
a
a
"}
(87,1,1) = {"
a
a
I
I
I
I
I
a
a
a
a
a
a
g
Q
Q
Q
Q
Q
Q
g
k
k
k
k
k
k
k
g
l
l
l
l
l
g
k
k
k
k
k
g
k
k
k
g
a
a
a
a
a
I
I
I
I
I
I
I
I
a
a
"}
(88,1,1) = {"
a
a
I
I
I
I
I
I
I
I
I
a
a
g
Q
Q
Q
Q
Q
Q
g
k
k
k
k
k
k
k
k
l
l
l
l
l
l
k
k
k
k
k
g
k
k
k
g
a
a
I
I
I
I
I
I
I
I
I
I
I
a
a
"}
(89,1,1) = {"
a
a
I
I
I
I
I
I
I
I
I
a
a
g
Q
Q
Q
Q
Q
Q
Q
k
k
k
k
k
k
k
g
l
l
l
l
l
g
k
k
k
g
g
g
g
k
g
g
a
a
I
I
I
I
I
I
I
I
I
I
I
a
a
"}
(90,1,1) = {"
a
a
I
I
I
I
I
I
I
I
I
a
a
g
g
g
Q
g
Q
Q
g
k
k
k
k
k
k
k
g
g
g
g
g
g
g
k
k
k
g
a
a
a
a
a
a
a
a
I
I
I
I
I
I
I
I
I
I
a
a
a
"}
(91,1,1) = {"
a
a
I
I
I
I
I
I
I
I
I
a
a
g
k
k
k
g
Q
Q
g
k
k
k
k
k
k
k
k
k
k
k
k
k
g
k
k
k
g
a
a
a
a
a
a
a
a
I
I
I
I
I
I
I
I
I
I
a
a
a
"}
(92,1,1) = {"
a
a
I
I
I
I
I
I
I
I
I
a
a
g
k
k
k
g
Q
Q
Q
k
k
k
k
k
k
k
k
k
k
k
k
k
g
k
k
k
g
a
a
a
a
a
a
a
a
I
I
I
I
I
I
I
I
I
I
a
a
a
"}
(93,1,1) = {"
a
a
I
I
I
I
I
I
I
I
I
a
a
g
k
k
k
g
Q
Q
g
k
k
k
k
k
k
k
k
k
k
k
k
k
g
g
g
g
g
a
a
a
a
a
a
a
a
I
I
I
I
I
I
I
I
I
I
a
a
a
"}
(94,1,1) = {"
a
a
I
I
I
I
I
I
I
I
I
a
a
g
g
g
g
g
g
g
g
g
g
g
g
g
g
g
g
g
g
g
g
g
g
a
a
a
a
a
I
I
I
a
a
I
I
I
I
I
I
I
I
I
I
I
I
a
a
a
"}
(95,1,1) = {"
a
a
I
I
I
I
I
I
I
I
I
a
a
a
a
a
a
a
a
a
a
a
a
a
a
a
a
a
a
a
a
a
a
a
a
a
a
a
a
a
I
I
I
a
a
I
I
I
I
a
a
a
a
I
I
I
I
a
a
a
"}
(96,1,1) = {"
a
a
I
I
I
I
I
I
I
I
I
a
a
B
a
a
a
a
a
a
a
a
a
a
a
a
a
a
a
a
a
a
a
a
a
a
a
a
a
a
I
I
I
a
a
a
a
a
a
a
I
I
a
I
I
I
I
a
a
a
"}
(97,1,1) = {"
a
a
I
I
I
I
I
I
I
I
I
a
a
a
a
a
a
a
a
a
a
a
a
a
I
I
a
a
a
a
a
a
a
a
I
a
a
a
a
a
I
I
I
I
I
I
I
I
I
I
I
I
a
I
I
I
I
a
a
a
"}
(98,1,1) = {"
a
a
a
I
I
I
I
I
I
I
I
I
I
I
I
I
I
I
I
I
I
I
I
I
I
I
a
a
a
a
a
a
a
a
I
I
I
I
I
I
I
I
I
I
I
I
I
I
I
I
I
I
a
I
I
I
I
a
a
a
"}
(99,1,1) = {"
a
a
a
I
I
I
I
I
I
I
I
I
I
I
I
I
I
I
I
I
I
I
I
I
I
I
a
a
a
a
a
a
a
a
I
I
I
I
I
a
a
a
a
a
a
a
a
a
a
a
a
a
a
I
I
I
I
a
a
a
"}
(100,1,1) = {"
a
a
a
a
I
I
I
I
I
I
I
I
I
I
I
I
I
I
I
I
I
I
I
I
I
I
a
a
a
a
a
a
a
a
I
I
I
I
I
a
I
I
I
I
I
I
I
I
I
I
I
I
I
I
I
I
I
a
a
a
"}
(101,1,1) = {"
a
a
a
a
I
I
I
I
I
I
I
I
I
I
I
I
I
I
I
I
I
I
I
I
I
I
I
I
I
I
I
I
I
I
I
I
I
I
I
a
I
I
I
I
I
I
I
I
I
I
I
I
I
I
I
I
I
a
a
a
"}
(102,1,1) = {"
a
a
a
a
a
I
I
I
I
I
I
I
I
I
I
I
I
I
I
I
I
I
I
I
I
I
I
I
I
I
I
I
I
I
I
a
a
a
a
a
I
I
I
I
I
I
I
I
I
I
I
I
I
I
I
I
a
a
a
a
"}
(103,1,1) = {"
a
a
a
a
a
a
a
a
I
I
I
I
I
I
I
I
I
I
I
I
I
I
I
I
I
I
I
I
I
I
I
I
I
I
I
a
I
I
I
I
I
I
I
I
I
I
I
I
I
I
I
I
I
a
a
a
a
a
a
a
"}
(104,1,1) = {"
a
a
a
a
a
a
a
a
a
a
a
a
a
a
a
a
a
a
a
a
a
a
a
a
I
I
I
I
I
I
I
I
I
I
I
a
I
I
I
I
a
a
a
a
a
a
a
a
a
a
a
a
a
a
a
a
a
a
a
a
"}
(105,1,1) = {"
a
a
a
a
a
a
a
a
a
a
a
a
a
a
a
a
a
a
a
a
a
a
a
a
a
a
a
a
a
a
a
a
a
a
a
a
a
a
a
a
a
a
a
a
a
a
a
a
a
a
a
a
a
a
a
a
a
a
a
a
"}
(106,1,1) = {"
a
a
a
a
a
a
a
a
a
a
a
a
a
a
a
a
a
a
a
a
a
a
a
a
a
a
a
a
a
a
a
a
a
a
a
a
a
a
a
a
a
a
a
a
a
a
a
a
a
a
a
a
a
a
a
a
a
a
a
a
"}
(107,1,1) = {"
a
a
a
a
a
a
a
a
a
a
a
a
a
a
a
a
a
a
a
a
a
a
a
a
a
a
a
a
a
a
a
a
a
a
a
a
a
a
a
a
a
a
a
a
a
a
a
a
a
a
a
a
a
a
a
a
a
a
a
a
"}
(108,1,1) = {"
a
a
a
a
a
a
a
a
a
a
a
a
a
a
a
a
a
a
a
a
a
a
a
a
a
a
a
a
a
a
a
a
a
a
a
a
a
a
a
a
a
a
a
a
a
a
a
a
a
a
a
a
a
a
a
a
a
a
a
a
"}
(109,1,1) = {"
a
a
a
a
a
a
a
a
a
a
a
a
a
a
a
a
a
a
a
a
a
a
a
a
a
a
a
a
a
a
a
a
a
a
a
a
a
a
a
a
a
a
a
a
a
a
a
a
a
a
a
a
a
a
a
a
a
a
a
a
"}
(110,1,1) = {"
a
a
a
a
a
a
a
a
a
a
a
a
a
a
a
a
a
a
a
a
a
a
a
a
a
a
a
a
a
a
a
a
a
a
a
a
a
a
a
a
a
a
a
a
a
a
a
a
a
a
a
a
a
a
a
a
a
a
a
a
"}
